AAAAAGAAGAT -> AAAAGAAGATA
AAAAAGCTGAT -> AAAAGCTGATA
AAAACACGATT -> AAACACGATTA
AAAACATTGGA -> AAACATTGGAA
AAAACGAGCGT -> AAACGAGCGTC
AAAACTTCTAT -> AAACTTCTATT
AAAAGAAGATA -> AAAGAAGATAC
AAAAGCTGATA -> AAAGCTGATAC
AAAAGGGGCCC -> AAAGGGGCCCC
AAAAGTGAGCA -> AAAGTGAGCAA
AAACACGATTA -> AACACGATTAA
AAACATTGGAA -> AACATTGGAAC
AAACATTGGTA -> AACATTGGTAG
AAACCGAAGGA -> AACCGAAGGAT
AAACGAGCGTC -> AACGAGCGTCA
AAACGCTGAAC -> AACGCTGAACC
AAACGCTGTCA -> AACGCTGTCAT
AAACTGAAGGC -> AACTGAAGGCG
AAACTTCTATT -> AACTTCTATTT
AAAGAAGATAC -> AAGAAGATACG
AAAGACCCCTA -> AAGACCCCTAG
AAAGCCGCGCA -> AAGCCGCGCAC
AAAGCGCCCAG -> AAGCGCCCAGG
AAAGCTGATAC -> AAGCTGATACG
AAAGGATCCGT -> AAGGATCCGTT
AAAGGGGCCCC -> AAGGGGCCCCT
AAAGGTGGCCA -> AAGGTGGCCAC
AAAGTACGACG -> AAGTACGACGA
AAAGTCGCGTC -> AAGTCGCGTCG
AAAGTGAGCAA -> AAGTGAGCAAC
AAATACGGTAG -> AATACGGTAGC
AAATATCAGGG -> AATATCAGGGG
AAATCATAAGC -> AATCATAAGCG
AAATGAGTGTA -> AATGAGTGTAA
AAATGCGTACT -> AATGCGTACTC
AAATTCCTTAA -> AATTCCTTAAA
AACACGATTAA -> ACACGATTAAG
AACACGCACTT -> ACACGCACTTC
AACAGTTTTCC -> ACAGTTTTCCT
AACATCGGACA -> ACATCGGACAC
AACATTCACTG -> ACATTCACTGA
AACATTGGAAC -> ACATTGGAACG
AACATTGGTAG -> ACATTGGTAGA
AACCAGGTAAT -> ACCAGGTAATT
AACCCGAGAAC -> ACCCGAGAACT
AACCGAAGGAT -> ACCGAAGGATT
AACCGAATCTG -> ACCGAATCTGT
AACCGAGTGTC -> ACCGAGTGTCG
AACCGGCGTTC -> ACCGGCGTTCA
AACCTTGGCCA -> ACCTTGGCCAC
AACGAAGGTAA -> ACGAAGGTAAT
AACGACTCCAG -> ACGACTCCAGA
AACGAGAACAT -> ACGAGAACATT
AACGAGCGTCA -> ACGAGCGTCAG
AACGCGTAAAT -> ACGCGTAAATA
AACGCTGAACC -> ACGCTGAACCT
AACGCTGTCAT -> ACGCTGTCATT
AACGGTACCCT -> ACGGTACCCTA
AACGTGACGCT -> ACGTGACGCTA
AACGTGACTAT -> ACGTGACTATC
AACTACATGCT -> ACTACATGCTG
AACTACCATGG -> ACTACCATGGT
AACTCATGACA -> ACTCATGACAG
AACTGAAGGCG -> ACTGAAGGCGT
AACTGAGGCAC -> ACTGAGGCACC
AACTGCCCTTT -> ACTGCCCTTTA
AACTGGCGGCA -> ACTGGCGGCAA
AACTGTGTGGG -> ACTGTGTGGGT
AACTGTTATCT -> ACTGTTATCTA
AACTTCTATTT -> ACTTCTATTTT
AACTTGTAAAT -> ACTTGTAAATT
AAGAACAGTTT -> AGAACAGTTTT
AAGAAGATACG -> AGAAGATACGA
AAGACAGCTTT -> AGACAGCTTTA
AAGACCCCTAG -> AGACCCCTAGT
AAGACGTAGGT -> AGACGTAGGTG
AAGAGGAATGA -> AGAGGAATGAT
AAGATACGAAA -> AGATACGAAAC
AAGCAATTGAA -> AGCAATTGAAT
AAGCATACAGC -> AGCATACAGCG
AAGCCAAATGA -> AGCCAAATGAG
AAGCCGCGCAC -> AGCCGCGCACC
AAGCGCCCAGG -> AGCGCCCAGGC
AAGCGTTCAAT -> AGCGTTCAATG
AAGCGTTGGTT -> AGCGTTGGTTT
AAGCTGATACG -> AGCTGATACGC
AAGGATCCGTT -> AGGATCCGTTC
AAGGATTTTGT -> AGGATTTTGTG
AAGGCGTATGT -> AGGCGTATGTT
AAGGGGCCCCT -> AGGGGCCCCTA
AAGGGGGTTTC -> AGGGGGTTTCC
AAGGGTCCAGT -> AGGGTCCAGTC
AAGGTAATGGA -> AGGTAATGGAC
AAGGTAATTTA -> AGGTAATTTAA
AAGGTGGCCAC -> AGGTGGCCACG
AAGTACGACGA -> AGTACGACGAC
AAGTAGTGCCA -> AGTAGTGCCAC
AAGTCGAACAC -> AGTCGAACACG
AAGTCGCGTCG -> AGTCGCGTCGG
AAGTGAGCAAC -> AGTGAGCAACG
AATACACTCGA -> ATACACTCGAA
AATACGGTAGC -> ATACGGTAGCC
AATACTGGAGA -> ATACTGGAGAG
AATAGAGATTA -> ATAGAGATTAA
AATATCAGGGG -> ATATCAGGGGT
AATCACTGGCC -> ATCACTGGCCG
AATCATAAGCG -> ATCATAAGCGT
AATCCCCACGA -> ATCCCCACGAA
AATCCGGGTAG -> ATCCGGGTAGC
AATCGACGCCT -> ATCGACGCCTC
AATCTGTAGTT -> ATCTGTAGTTC
AATGAACTGAG -> ATGAACTGAGG
AATGACCTTCT -> ATGACCTTCTT
AATGAGTGTAA -> ATGAGTGTAAC
AATGATAGATG -> ATGATAGATGA
AATGCACCCGC -> ATGCACCCGCC
AATGCGTACTC -> ATGCGTACTCA
AATGCTTGTCC -> ATGCTTGTCCA
AATGGACGCCA -> ATGGACGCCAC
AATGGTGGTAT -> ATGGTGGTATG
AATGTCTTTGG -> ATGTCTTTGGG
AATTCCCTCGA -> ATTCCCTCGAA
AATTCCTTAAA -> ATTCCTTAAAT
AATTGAACTAC -> ATTGAACTACA
AATTGAATACA -> ATTGAATACAC
AATTGGTGGGT -> ATTGGTGGGTA
AATTTAACTGT -> ATTTAACTGTT
AATTTCGCTCC -> ATTTCGCTCCC
ACAATGTCTTT -> CAATGTCTTTG
ACACGAAAACT -> CACGAAAACTT
ACACGATTAAG -> CACGATTAAGT
ACACGCACTTC -> CACGCACTTCA
ACACGTTGTCC -> CACGTTGTCCC
ACACTCCGGTC -> CACTCCGGTCG
ACACTCCGTAG -> CACTCCGTAGC
ACACTCGAACG -> CACTCGAACGA
ACAGATTGAAA -> CAGATTGAAAG
ACAGCGGTCAC -> CAGCGGTCACA
ACAGCTTTAGT -> CAGCTTTAGTG
ACAGGCGTATC -> CAGGCGTATCC
ACAGGGAATGC -> CAGGGAATGCA
ACAGGGTTATT -> CAGGGTTATTG
ACAGTAGACGC -> CAGTAGACGCG
ACAGTTTTCCT -> CAGTTTTCCTT
ACATCCGCCAG -> CATCCGCCAGG
ACATCGGACAC -> CATCGGACACG
ACATGATCAAT -> CATGATCAATG
ACATGCTGACT -> CATGCTGACTG
ACATGGAGTAT -> CATGGAGTATT
ACATGTGCTTG -> CATGTGCTTGT
ACATTCACTGA -> CATTCACTGAT
ACATTCTTTTC -> CATTCTTTTCT
ACATTGGAACG -> CATTGGAACGA
ACATTGGTAGA -> CATTGGTAGAA
ACCAAGACAGC -> CCAAGACAGCT
ACCAGAGTGGC -> CCAGAGTGGCA
ACCAGGTAATT -> CCAGGTAATTT
ACCATACGAAC -> CCATACGAACT
ACCATCAAAAC -> CCATCAAAACA
ACCATGGTGGT -> CCATGGTGGTC
ACCCCTAGTTG -> CCCCTAGTTGG
ACCCGAGAACT -> CCCGAGAACTG
ACCCGAGCTTC -> CCCGAGCTTCT
ACCCGCCCGTC -> CCCGCCCGTCT
ACCCTAAAACG -> CCCTAAAACGA
ACCGAAGGATT -> CCGAAGGATTT
ACCGAATCTGT -> CCGAATCTGTA
ACCGACGTCGT -> CCGACGTCGTC
ACCGAGTGTCG -> CCGAGTGTCGC
ACCGCACGAGC -> CCGCACGAGCT
ACCGCCGCTAC -> CCGCCGCTACG
ACCGGACGCAG -> CCGGACGCAGT
ACCGGCGTTCA -> CCGGCGTTCAT
ACCGTAAGCAA -> CCGTAAGCAAT
ACCTCCCGGGG -> CCTCCCGGGGG
ACCTGGATTTG -> CCTGGATTTGT
ACCTGTCCATA -> CCTGTCCATAA
ACCTTCTTGTC -> CCTTCTTGTCT
ACCTTGGCCAC -> CCTTGGCCACA
ACGAAAACTTC -> CGAAAACTTCT
ACGAAACGCTG -> CGAAACGCTGA
ACGAACTGTGT -> CGAACTGTGTG
ACGAAGGTAAT -> CGAAGGTAATT
ACGAATCCGGG -> CGAATCCGGGT
ACGACATGTGC -> CGACATGTGCT
ACGACATTCTT -> CGACATTCTTT
ACGACGACATG -> CGACGACATGT
ACGACTCCAGA -> CGACTCCAGAC
ACGAGAACATT -> CGAGAACATTC
ACGAGCGTCAG -> CGAGCGTCAGC
ACGAGCTGTAA -> CGAGCTGTAAA
ACGATTAAGTC -> CGATTAAGTCG
ACGATTCTGCA -> CGATTCTGCAT
ACGCACTTCAA -> CGCACTTCAAA
ACGCAGTTATC -> CGCAGTTATCA
ACGCCACTTTA -> CGCCACTTTAA
ACGCCAGTTTT -> CGCCAGTTTTT
ACGCCTCGCAA -> CGCCTCGCAAA
ACGCGAGATCC -> CGCGAGATCCC
ACGCGGCAGCT -> CGCGGCAGCTG
ACGCGTAAATA -> CGCGTAAATAT
ACGCTACAGAT -> CGCTACAGATT
ACGCTAGCCTC -> CGCTAGCCTCG
ACGCTGAACCT -> CGCTGAACCTT
ACGCTGTCATT -> CGCTGTCATTC
ACGGCCAGTTC -> CGGCCAGTTCG
ACGGGCGTACT -> CGGGCGTACTT
ACGGGGGCGAT -> CGGGGGCGATA
ACGGGTACTTA -> CGGGTACTTAA
ACGGTACCCTA -> CGGTACCCTAA
ACGGTAGCCAA -> CGGTAGCCAAG
ACGTAGGTGCT -> CGTAGGTGCTT
ACGTCCCTCAT -> CGTCCCTCATA
ACGTCGCGTGA -> CGTCGCGTGAC
ACGTCGTCCGA -> CGTCGTCCGAG
ACGTGACGCTA -> CGTGACGCTAG
ACGTGACTATC -> CGTGACTATCC
ACGTGGTCGAC -> CGTGGTCGACG
ACGTTGTCCCT -> CGTTGTCCCTC
ACTACATGCTG -> CTACATGCTGA
ACTACCATGGT -> CTACCATGGTG
ACTACGATTCT -> CTACGATTCTG
ACTATCCATCC -> CTATCCATCCC
ACTATCGGCAC -> CTATCGGCACA
ACTCACAGGCG -> CTCACAGGCGT
ACTCATGACAG -> CTCATGACAGT
ACTCCAGACGT -> CTCCAGACGTC
ACTCCGGTCGG -> CTCCGGTCGGG
ACTCCGTAGCT -> CTCCGTAGCTG
ACTCGAACGAA -> CTCGAACGAAG
ACTCGGATGGT -> CTCGGATGGTC
ACTCGGGCCCA -> CTCGGGCCCAA
ACTCGGGTCTT -> CTCGGGTCTTC
ACTCTAGTAGC -> CTCTAGTAGCT
ACTGAAGGCGT -> CTGAAGGCGTA
ACTGAGGCACC -> CTGAGGCACCG
ACTGATCATGA -> CTGATCATGAT
ACTGCCCTTTA -> CTGCCCTTTAC
ACTGGAGAGCG -> CTGGAGAGCGA
ACTGGCCGCGG -> CTGGCCGCGGA
ACTGGCGCCAG -> CTGGCGCCAGA
ACTGGCGGCAA -> CTGGCGGCAAC
ACTGTGCTATA -> CTGTGCTATAC
ACTGTGTGGGT -> CTGTGTGGGTC
ACTGTTATCTA -> CTGTTATCTAC
ACTTAAAGCCG -> CTTAAAGCCGC
ACTTAATGACC -> CTTAATGACCT
ACTTCAAAGGT -> CTTCAAAGGTG
ACTTCTATTTT -> CTTCTATTTTG
ACTTCTGATCA -> CTTCTGATCAG
ACTTGAGAGCA -> CTTGAGAGCAT
ACTTGTAAATT -> CTTGTAAATTC
ACTTTAACGCG -> CTTTAACGCGT
AGAAAGTACGA -> GAAAGTACGAC
AGAACAGTTTT -> GAACAGTTTTC
AGAACATCGGA -> GAACATCGGAC
AGAACATTCAC -> GAACATTCACT
AGAACTGCCCT -> GAACTGCCCTT
AGAAGATACGA -> GAAGATACGAA
AGAAGGTAATG -> GAAGGTAATGG
AGAATGCTTGT -> GAATGCTTGTC
AGAATGGTGGT -> GAATGGTGGTA
AGACAGCTTTA -> GACAGCTTTAG
AGACCCCTAGT -> GACCCCTAGTT
AGACGCGAGAT -> GACGCGAGATC
AGACGTAGGTG -> GACGTAGGTGC
AGACGTCCCTC -> GACGTCCCTCA
AGACTATCGGC -> GACTATCGGCA
AGAGATTAAAT -> GAGATTAAATC
AGAGCAACCGG -> GAGCAACCGGC
AGAGCATACAG -> GAGCATACAGG
AGAGCGAAACT -> GAGCGAAACTG
AGAGCGGATGA -> GAGCGGATGAG
AGAGCTTAGTT -> GAGCTTAGTTG
AGAGCTTTTGG -> GAGCTTTTGGT
AGAGGAATGAT -> GAGGAATGATA
AGAGTGGCACC -> GAGTGGCACCA
AGATACGAAAC -> GATACGAAACG
AGATATGTGCC -> GATATGTGCCC
AGATCCCCATG -> GATCCCCATGT
AGATGATAATA -> GATGATAATAG
AGATGATTATC -> GATGATTATCT
AGATTAAATCA -> GATTAAATCAT
AGATTGAAAGA -> GATTGAAAGAC
AGATTTTCATA -> GATTTTCATAC
AGCAACCGGCG -> GCAACCGGCGT
AGCAACGAGAA -> GCAACGAGAAC
AGCAATTGAAT -> GCAATTGAATA
AGCACCGTAAG -> GCACCGTAAGC
AGCAGCGTGTC -> GCAGCGTGTCG
AGCAGGGTCAC -> GCAGGGTCACT
AGCATAACCGA -> GCATAACCGAA
AGCATACAGCG -> GCATACAGCGG
AGCATACAGGG -> GCATACAGGGT
AGCATAGGAAA -> GCATAGGAAAA
AGCATTGAACC -> GCATTGAACCG
AGCCAAATGAG -> GCCAAATGAGT
AGCCAAGCGTT -> GCCAAGCGTTC
AGCCGCGCACC -> GCCGCGCACCT
AGCCTCGCGTA -> GCCTCGCGTAC
AGCGAAACTGA -> GCGAAACTGAA
AGCGCCCAGGC -> GCGCCCAGGCC
AGCGGACGTCG -> GCGGACGTCGC
AGCGGATGAGG -> GCGGATGAGGA
AGCGGGATTTG -> GCGGGATTTGA
AGCGGTCACAT -> GCGGTCACATC
AGCGTCACCGG -> GCGTCACCGGA
AGCGTCAGCGG -> GCGTCAGCGGG
AGCGTGTCGGT -> GCGTGTCGGTG
AGCGTTCAATG -> GCGTTCAATGA
AGCGTTGGTTT -> GCGTTGGTTTT
AGCTAATTGGT -> GCTAATTGGTG
AGCTACACTCC -> GCTACACTCCG
AGCTCAGAGCT -> GCTCAGAGCTT
AGCTCCAACTG -> GCTCCAACTGG
AGCTCGAATCC -> GCTCGAATCCC
AGCTGATACGC -> GCTGATACGCT
AGCTGCCTTTT -> GCTGCCTTTTA
AGCTGCTACAC -> GCTGCTACACT
AGCTGTAAACC -> GCTGTAAACCG
AGCTTAGTTGC -> GCTTAGTTGCG
AGCTTCTAGCA -> GCTTCTAGCAG
AGCTTTAGTGC -> GCTTTAGTGCG
AGCTTTTGGTC -> GCTTTTGGTCA,GCTTTTGGTCT
AGGAAAAGTGA -> GGAAAAGTGAG
AGGAATCGACG -> GGAATCGACGC
AGGAATGATAG -> GGAATGATAGA
AGGATCCGTTC -> GGATCCGTTCG
AGGATTTTGTG -> GGATTTTGTGT
AGGCACCGCCG -> GGCACCGCCGC
AGGCCACCAAG -> GGCCACCAAGA
AGGCGTATCCA -> GGCGTATCCAT
AGGCGTATGTT -> GGCGTATGTTT
AGGGAATGCAC -> GGGAATGCACC
AGGGGAGCTCG -> GGGGAGCTCGA
AGGGGCCCCTA -> GGGGCCCCTAT
AGGGGGTTTCC -> GGGGGTTTCCG
AGGGGTTCTAG -> GGGGTTCTAGA
AGGGTAGTATG -> GGGTAGTATGC
AGGGTCACTTG -> GGGTCACTTGA
AGGGTCCAGTC -> GGGTCCAGTCC
AGGGTTATTGG -> GGGTTATTGGA
AGGTAATGGAC -> GGTAATGGACG
AGGTAATTTAA -> GGTAATTTAAC
AGGTAATTTCG -> GGTAATTTCGC
AGGTCAAAGTC -> GGTCAAAGTCG
AGGTGCTTAAG -> GGTGCTTAAGG
AGGTGGCCACG -> GGTGGCCACGC
AGTACGACGAC -> GTACGACGACA
AGTAGACGCGA -> GTAGACGCGAG
AGTAGCTACAC -> GTAGCTACACT
AGTAGTGCCAC -> GTAGTGCCACG
AGTATGCTCCA -> GTATGCTCCAG
AGTATTAGTCA -> GTATTAGTCAT
AGTCATGCACA -> GTCATGCACAT
AGTCCATGGGT -> GTCCATGGGTT
AGTCGAACACG -> GTCGAACACGC
AGTCGCGTCGG -> GTCGCGTCGGT
AGTCGGCTGAT -> GTCGGCTGATA
AGTGAGCAACG -> GTGAGCAACGA
AGTGCCACGTG -> GTGCCACGTGG
AGTGCGGATAT -> GTGCGGATATG
AGTGGCACCAT -> GTGGCACCATA
AGTGTAACGTG -> GTGTAACGTGA
AGTGTCGCATC -> GTGTCGCATCG
AGTTATCAAAA -> GTTATCAAAAG
AGTTCGCTTTT -> GTTCGCTTTTG
AGTTCGGTAGC -> GTTCGGTAGCA
AGTTGCGATAG -> GTTGCGATAGA
AGTTGGGAAGC -> GTTGGGAAGCA
AGTTTTCCTTA -> GTTTTCCTTAT
AGTTTTTACCT -> GTTTTTACCTC
ATAACCGAATC -> TAACCGAATCT
ATAACTCATGA -> TAACTCATGAC
ATAAGCGTTGG -> TAAGCGTTGGT
ATAATAGAGAT -> TAATAGAGATT
ATAATCACTGG -> TAATCACTGGC
ATAATTCCCTC -> TAATTCCCTCG
ATACACTCGAA -> TACACTCGAAC
ATACAGCGGTC -> TACAGCGGTCA
ATACAGGGAAT -> TACAGGGAATG
ATACAGGGTTA -> TACAGGGTTAT
ATACCAGAGTG -> TACCAGAGTGG
ATACGAAACGC -> TACGAAACGCT
ATACGAACTGT -> TACGAACTGTG
ATACGCTACAG -> TACGCTACAGA
ATACGGTAGCC -> TACGGTAGCCA
ATACTCGGATG -> TACTCGGATGG
ATACTCGGGTC -> TACTCGGGTCT
ATACTGGAGAG -> TACTGGAGAGC
ATAGAATGCTT -> TAGAATGCTTG
ATAGAGATTAA -> TAGAGATTAAA
ATAGATGATTA -> TAGATGATTAT
ATAGCGTCACC -> TAGCGTCACCG
ATAGGAAAAGT -> TAGGAAAAGTG
ATATAATCACT -> TATAATCACTG
ATATCAGGGGT -> TATCAGGGGTT
ATATCTTGATG -> TATCTTGATGA
ATATCTTGGCA -> TATCTTGGCAC
ATATGAGAATG -> TATGAGAATGG
ATATGAGGGGA -> TATGAGGGGAG
ATATGTGCCCA -> TATGTGCCCAG
ATCAAAACATT -> TCAAAACATTG
ATCAAAAGGGG -> TCAAAAGGGGC
ATCACTGGCCG -> TCACTGGCCGC
ATCAGGGGTTC -> TCAGGGGTTCT
ATCAGTCGGCT -> TCAGTCGGCTG
ATCATAAGCGT -> TCATAAGCGTT
ATCATGATCGG -> TCATGATCGGG
ATCCATACCAG -> TCCATACCAGA
ATCCATCCCTG -> TCCATCCCTGA
ATCCCCACGAA -> TCCCCACGAAT
ATCCCCATGTG -> TCCCCATGTGT
ATCCCTGAGCA -> TCCCTGAGCAC
ATCCGCCAGGG -> TCCGCCAGGGT
ATCCGGGTAGC -> TCCGGGTAGCT
ATCCGTTCGGA -> TCCGTTCGGAG
ATCCTTGCTTA -> TCCTTGCTTAC
ATCGACGCCTC -> TCGACGCCTCG
ATCGGACACGA -> TCGGACACGAA
ATCGGCACACG -> TCGGCACACGT
ATCGGGTCGGC -> TCGGGTCGGCG
ATCGGTTGAGA -> TCGGTTGAGAG
ATCTACGGGGG -> TCTACGGGGGC
ATCTCTAAGGG -> TCTCTAAGGGT
ATCTGTAGTTC -> TCTGTAGTTCG
ATCTTAGATTT -> TCTTAGATTTT
ATCTTGATGAT -> TCTTGATGATT
ATCTTGGCACC -> TCTTGGCACCC
ATGAACTGAGG -> TGAACTGAGGC
ATGAAGAACAG -> TGAAGAACAGT
ATGAAGAGGAA -> TGAAGAGGAAT
ATGACAGTAGA -> TGACAGTAGAC
ATGACCTTCTT -> TGACCTTCTTG
ATGAGAATGGT -> TGAGAATGGTG
ATGAGGAATCG -> TGAGGAATCGA
ATGAGGGGAGC -> TGAGGGGAGCT
ATGAGTGTAAC -> TGAGTGTAACG
ATGATAATAGA -> TGATAATAGAG
ATGATAGATGA -> TGATAGATGAT
ATGATCAATGT -> TGATCAATGTC
ATGATCGGGTC -> TGATCGGGTCG
ATGATTATCTT -> TGATTATCTTA
ATGATTCGGCC -> TGATTCGGCCC
ATGCACATGAT -> TGCACATGATC
ATGCACCCGCC -> TGCACCCGCCC
ATGCCGGCATA -> TGCCGGCATAG
ATGCGGAGAGC -> TGCGGAGAGCA
ATGCGTACTCA -> TGCGTACTCAC
ATGCTCCAGAA -> TGCTCCAGAAC
ATGCTGACTGG -> TGCTGACTGGC
ATGCTTGTCCA -> TGCTTGTCCAA
ATGGACGCCAC -> TGGACGCCACT
ATGGAGCATAA -> TGGAGCATAAC
ATGGAGTATTA -> TGGAGTATTAG
ATGGCGCGTTT -> TGGCGCGTTTT
ATGGGCTCACT -> TGGGCTCACTT
ATGGGTTCAAA -> TGGGTTCAAAA
ATGGTCGGTTT -> TGGTCGGTTTT
ATGGTGGTATG -> TGGTGGTATGG
ATGGTGGTCTA -> TGGTGGTCTAG
ATGTACTCTAG -> TGTACTCTAGT
ATGTCTTTGGG -> TGTCTTTGGGA
ATGTGCCCAGG -> TGTGCCCAGGT
ATGTGCTTGTC -> TGTGCTTGTCT
ATGTGTCAAAC -> TGTGTCAAACA
ATGTTTGCTGG -> TGTTTGCTGGC
ATTAAATCATA -> TTAAATCATAA
ATTAAGTCGAA -> TTAAGTCGAAC
ATTAGTCATGC -> TTAGTCATGCA
ATTATCTTAGA -> TTATCTTAGAT
ATTCACCGACG -> TTCACCGACGT
ATTCACTGATC -> TTCACTGATCA
ATTCCCTCGAA -> TTCCCTCGAAC
ATTCCTTAAAT -> TTCCTTAAATA
ATTCGGCCCCT -> TTCGGCCCCTT
ATTCTGCATGA -> TTCTGCATGAA
ATTCTGCGAGC -> TTCTGCGAGCA
ATTCTTTTCTA -> TTCTTTTCTAT
ATTGAAAGACC -> TTGAAAGACCC
ATTGAACCGAG -> TTGAACCGAGT
ATTGAACTACA -> TTGAACTACAT
ATTGAATACAC -> TTGAATACACT
ATTGGAAAGCG -> TTGGAAAGCGC
ATTGGAACGAC -> TTGGAACGACT
ATTGGTAGAAA -> TTGGTAGAAAG
ATTGGTGGGTA -> TTGGTGGGTAG
ATTTAACTGTT -> TTTAACTGTTA
ATTTCGCTCCC -> TTTCGCTCCCT
ATTTGAAAACA -> TTTGAAAACAC
ATTTGACCATC -> TTTGACCATCA
ATTTGTCTTGG -> TTTGTCTTGGC
ATTTTCATACA -> TTTTCATACAG
ATTTTGAGCTA -> TTTTGAGCTAA
ATTTTGTGTCT -> TTTTGTGTCTG
CAAAAAGAAGA -> AAAAAGAAGAT
CAAAAAGCTGA -> AAAAAGCTGAT
CAAAACATTGG -> AAAACATTGGA
CAAAAGGGGCC -> AAAAGGGGCCC
CAAACATTGGT -> AAACATTGGTA
CAAAGGTGGCC -> AAAGGTGGCCA
CAAAGTCGCGT -> AAAGTCGCGTC
CAAATGAGTGT -> AAATGAGTGTA
CAACCCGAGAA -> AACCCGAGAAC
CAACCGGCGTT -> AACCGGCGTTC
CAACGAGAACA -> AACGAGAACAT
CAACGTGACTA -> AACGTGACTAT
CAACTGGCGGC -> AACTGGCGGCA
CAACTTGTAAA -> AACTTGTAAAT
CAAGACAGCTT -> AAGACAGCTTT
CAAGCGTTCAA -> AAGCGTTCAAT
CAATGAACTGA -> AATGAACTGAG
CAATGTCTTTG -> AATGTCTTTGG
CAATTGAATAC -> AATTGAATACA
CACAATGTCTT -> ACAATGTCTTT
CACACGTTGTC -> ACACGTTGTCC
CACAGGCGTAT -> ACAGGCGTATC
CACATCCGCCA -> ACATCCGCCAG
CACATGATCAA -> ACATGATCAAT
CACCAAGACAG -> ACCAAGACAGC
CACCATACGAA -> ACCATACGAAC
CACCCGAGCTT -> ACCCGAGCTTC
CACCCGCCCGT -> ACCCGCCCGTC
CACCGACGTCG -> ACCGACGTCGT
CACCGCCGCTA -> ACCGCCGCTAC
CACCGGACGCA -> ACCGGACGCAG
CACCGTAAGCA -> ACCGTAAGCAA
CACCTGTCCAT -> ACCTGTCCATA
CACGAAAACTT -> ACGAAAACTTC
CACGAATCCGG -> ACGAATCCGGG
CACGAGCTGTA -> ACGAGCTGTAA
CACGATTAAGT -> ACGATTAAGTC
CACGCACTTCA -> ACGCACTTCAA
CACGCGGCAGC -> ACGCGGCAGCT
CACGGGCGTAC -> ACGGGCGTACT
CACGTGGTCGA -> ACGTGGTCGAC
CACGTTGTCCC -> ACGTTGTCCCT
CACTACGATTC -> ACTACGATTCT
CACTCCGGTCG -> ACTCCGGTCGG
CACTCCGTAGC -> ACTCCGTAGCT
CACTCGAACGA -> ACTCGAACGAA
CACTGATCATG -> ACTGATCATGA
CACTGGCCGCG -> ACTGGCCGCGG
CACTTCAAAGG -> ACTTCAAAGGT
CACTTCTGATC -> ACTTCTGATCA
CACTTGAGAGC -> ACTTGAGAGCA
CACTTTAACGC -> ACTTTAACGCG
CAGAACATCGG -> AGAACATCGGA
CAGACGTCCCT -> AGACGTCCCTC
CAGAGCTTTTG -> AGAGCTTTTGG
CAGAGTGGCAC -> AGAGTGGCACC
CAGATGATAAT -> AGATGATAATA
CAGATTGAAAG -> AGATTGAAAGA
CAGCGGGATTT -> AGCGGGATTTG
CAGCGGTCACA -> AGCGGTCACAT
CAGCGTGTCGG -> AGCGTGTCGGT
CAGCTCCAACT -> AGCTCCAACTG
CAGCTGCCTTT -> AGCTGCCTTTT
CAGCTTTAGTG -> AGCTTTAGTGC
CAGGCCACCAA -> AGGCCACCAAG
CAGGCGTATCC -> AGGCGTATCCA
CAGGGAATGCA -> AGGGAATGCAC
CAGGGGTTCTA -> AGGGGTTCTAG
CAGGGTAGTAT -> AGGGTAGTATG
CAGGGTCACTT -> AGGGTCACTTG
CAGGGTTATTG -> AGGGTTATTGG
CAGGTAATTTC -> AGGTAATTTCG
CAGGTCAAAGT -> AGGTCAAAGTC
CAGTAGACGCG -> AGTAGACGCGA
CAGTCCATGGG -> AGTCCATGGGT
CAGTCGGCTGA -> AGTCGGCTGAT
CAGTTATCAAA -> AGTTATCAAAA
CAGTTCGGTAG -> AGTTCGGTAGC
CAGTTTTCCTT -> AGTTTTCCTTA
CAGTTTTTACC -> AGTTTTTACCT
CATAACCGAAT -> ATAACCGAATC
CATAAGCGTTG -> ATAAGCGTTGG
CATAATTCCCT -> ATAATTCCCTC
CATACAGCGGT -> ATACAGCGGTC
CATACAGGGAA -> ATACAGGGAAT
CATACAGGGTT -> ATACAGGGTTA
CATACCAGAGT -> ATACCAGAGTG
CATACGAACTG -> ATACGAACTGT
CATAGCGTCAC -> ATAGCGTCACC
CATAGGAAAAG -> ATAGGAAAAGT
CATATCTTGAT -> ATATCTTGATG
CATATGAGGGG -> ATATGAGGGGA
CATCAAAACAT -> ATCAAAACATT
CATCCCTGAGC -> ATCCCTGAGCA
CATCCGCCAGG -> ATCCGCCAGGG
CATCGGACACG -> ATCGGACACGA
CATCGGTTGAG -> ATCGGTTGAGA
CATGAAGAACA -> ATGAAGAACAG
CATGACAGTAG -> ATGACAGTAGA
CATGATCAATG -> ATGATCAATGT
CATGATCGGGT -> ATGATCGGGTC
CATGCACATGA -> ATGCACATGAT
CATGCGGAGAG -> ATGCGGAGAGC
CATGCTGACTG -> ATGCTGACTGG
CATGGAGTATT -> ATGGAGTATTA
CATGGGTTCAA -> ATGGGTTCAAA
CATGGTGGTCT -> ATGGTGGTCTA
CATGTGCTTGT -> ATGTGCTTGTC
CATGTGTCAAA -> ATGTGTCAAAC
CATTCACCGAC -> ATTCACCGACG
CATTCACTGAT -> ATTCACTGATC
CATTCTGCGAG -> ATTCTGCGAGC
CATTCTTTTCT -> ATTCTTTTCTA
CATTGAACCGA -> ATTGAACCGAG
CATTGGAACGA -> ATTGGAACGAC
CATTGGTAGAA -> ATTGGTAGAAA
CATTTGACCAT -> ATTTGACCATC
CCAAATGAGTG -> CAAATGAGTGT
CCAACGTGACT -> CAACGTGACTA
CCAACTGGCGG -> CAACTGGCGGC
CCAACTTGTAA -> CAACTTGTAAA
CCAAGACAGCT -> CAAGACAGCTT
CCAAGCGTTCA -> CAAGCGTTCAA
CCACAATGTCT -> CACAATGTCTT
CCACCAAGACA -> CACCAAGACAG
CCACGAATCCG -> CACGAATCCGG
CCACGCGGCAG -> CACGCGGCAGC
CCACGTGGTCG -> CACGTGGTCGA
CCACTTTAACG -> CACTTTAACGC
CCAGAACATCG -> CAGAACATCGG
CCAGACGTCCC -> CAGACGTCCCT
CCAGAGTGGCA -> CAGAGTGGCAC
CCAGATGATAA -> CAGATGATAAT
CCAGGCCACCA -> CAGGCCACCAA
CCAGGGTAGTA -> CAGGGTAGTAT
CCAGGTAATTT -> CAGGTAATTTC
CCAGGTCAAAG -> CAGGTCAAAGT
CCAGTCCATGG -> CAGTCCATGGG
CCAGTTCGGTA -> CAGTTCGGTAG
CCAGTTTTTAC -> CAGTTTTTACC
CCATAATTCCC -> CATAATTCCCT
CCATACCAGAG -> CATACCAGAGT
CCATACGAACT -> CATACGAACTG
CCATCAAAACA -> CATCAAAACAT
CCATCCCTGAG -> CATCCCTGAGC
CCATGCGGAGA -> CATGCGGAGAG
CCATGGGTTCA -> CATGGGTTCAA
CCATGGTGGTC -> CATGGTGGTCT
CCATGTGTCAA -> CATGTGTCAAA
CCCAACGTGAC -> CCAACGTGACT
CCCACGAATCC -> CCACGAATCCG
CCCAGGCCACC -> CCAGGCCACCA
CCCAGGTCAAA -> CCAGGTCAAAG
CCCATGTGTCA -> CCATGTGTCAA
CCCCACGAATC -> CCCACGAATCC
CCCCATGTGTC -> CCCATGTGTCA
CCCCTAGTTGG -> CCCTAGTTGGG
CCCCTATGGAG -> CCCTATGGAGC
CCCCTTACCTG -> CCCTTACCTGG
CCCGAGAACTG -> CCGAGAACTGC
CCCGAGCTTCT -> CCGAGCTTCTA
CCCGCCCGTCT -> CCGCCCGTCTT
CCCGGGGGAAT -> CCGGGGGAATT
CCCGTCTTCTT -> CCGTCTTCTTA
CCCTAAAACGA -> CCTAAAACGAG
CCCTAGTTGGG -> CCTAGTTGGGA
CCCTATGGAGC -> CCTATGGAGCA
CCCTCATATCT -> CCTCATATCTT
CCCTCCGAGCA -> CCTCCGAGCAT
CCCTCGAACTA -> CCTCGAACTAC
CCCTGAGCACC -> CCTGAGCACCG
CCCTGGGCGTC -> CCTGGGCGTCA
CCCTTACCTGG -> CCTTACCTGGA
CCCTTTACGGG -> CCTTTACGGGT
CCGAAGGATTT -> CGAAGGATTTT
CCGAATCTGTA -> CGAATCTGTAG
CCGACGTCGTC -> CGACGTCGTCC
CCGAGAACTGC -> CGAGAACTGCC
CCGAGCATTGA -> CGAGCATTGAA
CCGAGCTTCTA -> CGAGCTTCTAG
CCGAGCTTTTG -> CGAGCTTTTGG
CCGAGTGTCGC -> CGAGTGTCGCA
CCGCACGAGCT -> CGCACGAGCTG
CCGCCAGGGTA -> CGCCAGGGTAG
CCGCCCGTCTT -> CGCCCGTCTTC
CCGCCGCTACG -> CGCCGCTACGG
CCGCGCACCTG -> CGCGCACCTGT
CCGCGGACATG -> CGCGGACATGG
CCGCTACGGCC -> CGCTACGGCCA
CCGGACGCAGT -> CGGACGCAGTT
CCGGCATAGCG -> CGGCATAGCGT
CCGGCGTTCAT -> CGGCGTTCATA
CCGGGGGAATT -> CGGGGGAATTG
CCGGGTAGCTC -> CGGGTAGCTCA
CCGGTAACCAG -> CGGTAACCAGG
CCGGTCGGGGA -> CGGTCGGGGAA
CCGGTGTATGA -> CGGTGTATGAA
CCGTAAGCAAT -> CGTAAGCAATT
CCGTAGCTGCT -> CGTAGCTGCTA
CCGTCTTCTTA -> CGTCTTCTTAT
CCGTTCGGAGA -> CGTTCGGAGAA
CCTAAAACGAG -> CTAAAACGAGC
CCTAGTTGGGA -> CTAGTTGGGAA
CCTATGGAGCA -> CTATGGAGCAT
CCTCATATCTT -> CTCATATCTTG
CCTCCCGGGGG -> CTCCCGGGGGA
CCTCCGAGCAT -> CTCCGAGCATT
CCTCGAACTAC -> CTCGAACTACC
CCTCGCAAAAA -> CTCGCAAAAAG
CCTCGCGTACG -> CTCGCGTACGC
CCTGAGCACCG -> CTGAGCACCGT
CCTGGATTTGT -> CTGGATTTGTC
CCTGGGCGTCA -> CTGGGCGTCAC
CCTGTCCATAA -> CTGTCCATAAT
CCTTAAATACG -> CTTAAATACGG
CCTTACCTGGA -> CTTACCTGGAT
CCTTATGCCGG -> CTTATGCCGGC
CCTTCTTGTCT -> CTTCTTGTCTT
CCTTGCTTACT -> CTTGCTTACTG
CCTTGGCCACA -> CTTGGCCACAA
CCTTTACGGGT -> CTTTACGGGTA
CCTTTTATGTA -> CTTTTATGTAC
CGAAAACTTCT -> GAAAACTTCTA
CGAAACGCTGA -> GAAACGCTGAA
CGAAACTGAAG -> GAAACTGAAGG
CGAACACGCAC -> GAACACGCACT
CGAACGAAGGT -> GAACGAAGGTA
CGAACTACCAT -> GAACTACCATG
CGAACTGTGTG -> GAACTGTGTGG
CGAAGGATTTT -> GAAGGATTTTG
CGAAGGTAATT -> GAAGGTAATTT
CGAATCCCCAC -> GAATCCCCACG
CGAATCCGGGT -> GAATCCGGGTA
CGAATCTGTAG -> GAATCTGTAGT
CGACATGTGCT -> GACATGTGCTT
CGACATTCTTT -> GACATTCTTTT
CGACGACATGT -> GACGACATGTG
CGACGACATTC -> GACGACATTCT
CGACGCCTCGC -> GACGCCTCGCA
CGACGTCGTCC -> GACGTCGTCCG
CGACTCCAGAC -> GACTCCAGACG
CGAGAACATTC -> GAGAACATTCA
CGAGAACTGCC -> GAGAACTGCCC
CGAGATCCCCA -> GAGATCCCCAT
CGAGCATAGGA -> GAGCATAGGAA
CGAGCATTGAA -> GAGCATTGAAC
CGAGCGTCAGC -> GAGCGTCAGCG
CGAGCTGTAAA -> GAGCTGTAAAC
CGAGCTTCTAG -> GAGCTTCTAGC
CGAGCTTTTGG -> GAGCTTTTGGT
CGAGTGTCGCA -> GAGTGTCGCAT
CGATAGAATGC -> GATAGAATGCT
CGATATCTTGG -> GATATCTTGGC
CGATTAAGTCG -> GATTAAGTCGA
CGATTCTGCAT -> GATTCTGCATG
CGCAAAAAGAA -> GCAAAAAGAAG
CGCACCTGTCC -> GCACCTGTCCA
CGCACGAGCTG -> GCACGAGCTGT
CGCACTTCAAA -> GCACTTCAAAG
CGCAGTTATCA -> GCAGTTATCAA
CGCATCGGTTG -> GCATCGGTTGA
CGCCACTTTAA -> GCCACTTTAAC
CGCCAGATGAT -> GCCAGATGATA
CGCCAGGGTAG -> GCCAGGGTAGT
CGCCAGTTTTT -> GCCAGTTTTTA
CGCCATGCGGA -> GCCATGCGGAG
CGCCCAGGCCA -> GCCCAGGCCAC
CGCCCGTCTTC -> GCCCGTCTTCT
CGCCGCTACGG -> GCCGCTACGGC
CGCCTCGCAAA -> GCCTCGCAAAA
CGCGAGATCCC -> GCGAGATCCCC
CGCGCACCTGT -> GCGCACCTGTC
CGCGGACATGG -> GCGGACATGGA
CGCGGCAGCTG -> GCGGCAGCTGC
CGCGTAAATAT -> GCGTAAATATC
CGCGTACGCCA -> GCGTACGCCAG
CGCGTCGGTCG -> GCGTCGGTCGC
CGCGTGACCGC -> GCGTGACCGCA
CGCGTTTTGAT -> GCGTTTTGATA
CGCTACAGATT -> GCTACAGATTG
CGCTACGGCCA -> GCTACGGCCAG
CGCTAGCCTCG -> GCTAGCCTCGC
CGCTCCCTGGG -> GCTCCCTGGGC
CGCTGAACCTT -> GCTGAACCTTG
CGCTGTCATTC -> GCTGTCATTCT
CGCTTAAAGGA -> GCTTAAAGGAT
CGCTTTTGTAT -> GCTTTTGTATC
CGGACACGAAA -> GGACACGAAAA
CGGACATGGAG -> GGACATGGAGT
CGGACGCAGTT -> GGACGCAGTTA
CGGACGTCGCG -> GGACGTCGCGT
CGGAGAAGGTA -> GGAGAAGGTAA
CGGAGAGCAAC -> GGAGAGCAACC
CGGATATGAGA -> GGATATGAGAA
CGGATGAGGAA -> GGATGAGGAAT
CGGATGGTCGG -> GGATGGTCGGT
CGGCAACCCGA -> GGCAACCCGAG
CGGCACACGTT -> GGCACACGTTG
CGGCAGCTGCC -> GGCAGCTGCCT
CGGCATAGCGT -> GGCATAGCGTC
CGGCCAGTTCG -> GGCCAGTTCGG
CGGCCCCTTAC -> GGCCCCTTACC
CGGCGGGCGCT -> GGCGGGCGCTT
CGGCGTTCATA -> GGCGTTCATAT
CGGCTGATATA -> GGCTGATATAA
CGGGATTTGAA -> GGGATTTGAAA
CGGGCCCAACG -> GGGCCCAACGT
CGGGCGCTTAA -> GGGCGCTTAAA
CGGGCGTACTT -> GGGCGTACTTA
CGGGGAAGTAG -> GGGGAAGTAGT
CGGGGGAATTG -> GGGGGAATTGA
CGGGGGCGATA -> GGGGGCGATAT
CGGGTACTTAA -> GGGTACTTAAA
CGGGTAGCTCA -> GGGTAGCTCAG
CGGGTCGGCGG -> GGGTCGGCGGG
CGGGTCTTCTG -> GGGTCTTCTGT
CGGTAACCAGG -> GGTAACCAGGT
CGGTACCCTAA -> GGTACCCTAAA
CGGTAGCAGCG -> GGTAGCAGCGT
CGGTAGCCAAG -> GGTAGCCAAGC
CGGTCACATCC -> GGTCACATCCG
CGGTCCGGTGT -> GGTCCGGTGTA
CGGTCGCCATG -> GGTCGCCATGC
CGGTCGGGGAA -> GGTCGGGGAAG
CGGTGAGACTA -> GGTGAGACTAT
CGGTGTATGAA -> GGTGTATGAAG
CGGTTGAGAGC -> GGTTGAGAGCG
CGGTTTTTAAG -> GGTTTTTAAGA
CGTAAATATCA -> GTAAATATCAG
CGTAAGCAATT -> GTAAGCAATTG
CGTACGCCAGT -> GTACGCCAGTT
CGTACTCACAG -> GTACTCACAGG
CGTACTTAATG -> GTACTTAATGA
CGTAGCTGCTA -> GTAGCTGCTAC
CGTAGGTGCTT -> GTAGGTGCTTA
CGTATCCATAC -> GTATCCATACC
CGTATGTTTGC -> GTATGTTTGCT
CGTCACCGGAC -> GTCACCGGACG
CGTCACTACGA -> GTCACTACGAT
CGTCAGCGGGA -> GTCAGCGGGAT
CGTCCCTCATA -> GTCCCTCATAT
CGTCCGAGCTT -> GTCCGAGCTTT
CGTCGCGTGAC -> GTCGCGTGACC
CGTCGGTCGCC -> GTCGGTCGCCA
CGTCGTCCGAG -> GTCGTCCGAGC
CGTCTTCTTAT -> GTCTTCTTATC
CGTGACCGCAC -> GTGACCGCACG
CGTGACGCTAG -> GTGACGCTAGC
CGTGACTATCC -> GTGACTATCCA
CGTGGTCGACG -> GTGGTCGACGA
CGTGTCGGTGA -> GTGTCGGTGAG
CGTTCAATGAA -> GTTCAATGAAC
CGTTCATATGA -> GTTCATATGAG
CGTTCGGAGAA -> GTTCGGAGAAG
CGTTGGTTTTT -> GTTGGTTTTTA
CGTTGTCCCTC -> GTTGTCCCTCC
CGTTTTGATAA -> GTTTTGATAAC
CTAAAACGAGC -> TAAAACGAGCG
CTAACGGTACC -> TAACGGTACCC
CTAAGGGTCCA -> TAAGGGTCCAG
CTAATTGGTGG -> TAATTGGTGGG
CTACACTCCGG -> TACACTCCGGT
CTACACTCCGT -> TACACTCCGTA
CTACAGATTGA -> TACAGATTGAA
CTACATGCTGA -> TACATGCTGAC
CTACCATGGTG -> TACCATGGTGG
CTACGATTCTG -> TACGATTCTGC
CTACGGCCAGT -> TACGGCCAGTT
CTACGGGGGCG -> TACGGGGGCGA
CTAGAGCTTAG -> TAGAGCTTAGT
CTAGATATGTG -> TAGATATGTGC
CTAGCAGGGTC -> TAGCAGGGTCA
CTAGCCTCGCG -> TAGCCTCGCGT
CTAGTAGCTAC -> TAGTAGCTACA
CTAGTTGGGAA -> TAGTTGGGAAG
CTATACTCGGA -> TATACTCGGAT
CTATACTCGGG -> TATACTCGGGT
CTATCCATCCC -> TATCCATCCCT
CTATCGGCACA -> TATCGGCACAC
CTATGGAGCAT -> TATGGAGCATA
CTATTTTGAGC -> TATTTTGAGCT
CTCACAGGCGT -> TCACAGGCGTA
CTCACTTCTGA -> TCACTTCTGAT
CTCAGAGCTTT -> TCAGAGCTTTT
CTCAGCTCCAA -> TCAGCTCCAAC
CTCATATCTTG -> TCATATCTTGA
CTCATGACAGT -> TCATGACAGTA
CTCCAACTGGC -> TCCAACTGGCG
CTCCAGAACAT -> TCCAGAACATC
CTCCAGACGTC -> TCCAGACGTCC
CTCCCGGGGGA -> TCCCGGGGGAA
CTCCCTGGGCG -> TCCCTGGGCGT
CTCCGAGCATT -> TCCGAGCATTG
CTCCGGTCGGG -> TCCGGTCGGGG
CTCCGTAGCTG -> TCCGTAGCTGC
CTCGAACGAAG -> TCGAACGAAGG
CTCGAACTACC -> TCGAACTACCA
CTCGAATCCCC -> TCGAATCCCCA
CTCGCAAAAAG -> TCGCAAAAAGA
CTCGCGTACGC -> TCGCGTACGCC
CTCGGATGGTC -> TCGGATGGTCG
CTCGGGCCCAA -> TCGGGCCCAAC
CTCGGGTCTTC -> TCGGGTCTTCT
CTCTAAGGGTC -> TCTAAGGGTCC
CTCTAGTAGCT -> TCTAGTAGCTA
CTGAACCTTGG -> TGAACCTTGGC
CTGAAGGCGTA -> TGAAGGCGTAT
CTGAATACTGG -> TGAATACTGGA
CTGACTGGCGC -> TGACTGGCGCC
CTGAGCACCGT -> TGAGCACCGTA
CTGAGGCACCG -> TGAGGCACCGC
CTGATACGCTA -> TGATACGCTAC
CTGATATAATC -> TGATATAATCA
CTGATCAGTCG -> TGATCAGTCGG
CTGATCATGAT -> TGATCATGATC
CTGCATGAAGA -> TGCATGAAGAA
CTGCCCTTTAC -> TGCCCTTTACG
CTGCCTTTTAT -> TGCCTTTTATG
CTGCGAGCATA -> TGCGAGCATAG
CTGCTACACTC -> TGCTACACTCC
CTGGAGAGCGA -> TGGAGAGCGAA
CTGGATTTGTC -> TGGATTTGTCT
CTGGCATTCAC -> TGGCATTCACC
CTGGCCGCGGA -> TGGCCGCGGAC
CTGGCGCCAGA -> TGGCGCCAGAT
CTGGCGGCAAC -> TGGCGGCAACC
CTGGGCGTCAC -> TGGGCGTCACT
CTGGTTAAGCC -> TGGTTAAGCCA
CTGTAAACCGA -> TGTAAACCGAA
CTGTAGTTCGC -> TGTAGTTCGCT
CTGTCATTCTG -> TGTCATTCTGC
CTGTCCATAAT -> TGTCCATAATT
CTGTGCTATAC -> TGTGCTATACT
CTGTGGAAACG -> TGTGGAAACGC
CTGTGTGGGTC -> TGTGTGGGTCA
CTGTTATCTAC -> TGTTATCTACG
CTTAAAGCCGC -> TTAAAGCCGCG
CTTAAAGGATC -> TTAAAGGATCC
CTTAAATACGG -> TTAAATACGGT
CTTAAGGGGGT -> TTAAGGGGGTT
CTTAATGACCT -> TTAATGACCTT
CTTACCTGGAT -> TTACCTGGATT
CTTACTGTGCT -> TTACTGTGCTA
CTTAGATTTTC -> TTAGATTTTCA
CTTAGTTGCGA -> TTAGTTGCGAT
CTTATCCTTGC -> TTATCCTTGCT
CTTATGCCGGC -> TTATGCCGGCA
CTTCAAAGGTG -> TTCAAAGGTGG
CTTCTAGCAGG -> TTCTAGCAGGG
CTTCTATTTTG -> TTCTATTTTGA
CTTCTGATCAG -> TTCTGATCAGT
CTTCTGTGGAA -> TTCTGTGGAAA
CTTCTTATCCT -> TTCTTATCCTT
CTTCTTGAAAT -> TTCTTGAAATG
CTTCTTGTCTT -> TTCTTGTCTTC
CTTGAAATGCG -> TTGAAATGCGT
CTTGAGAGCAT -> TTGAGAGCATA
CTTGATGATTC -> TTGATGATTCG
CTTGCTTACTG -> TTGCTTACTGT
CTTGGCACCCG -> TTGGCACCCGA
CTTGGCCACAA -> TTGGCCACAAT
CTTGGCTAACG -> TTGGCTAACGG
CTTGTAAATTC -> TTGTAAATTCC
CTTGTCCAACT -> TTGTCCAACTT
CTTGTCTGAAT -> TTGTCTGAATA
CTTGTCTTCTT -> TTGTCTTCTTG
CTTTAACGCGT -> TTTAACGCGTA
CTTTACGGGTA -> TTTACGGGTAC
CTTTAGTGCGG -> TTTAGTGCGGA
CTTTGGGATGG -> TTTGGGATGGG
CTTTTATGTAC -> TTTTATGTACT
CTTTTCTATAC -> TTTTCTATACT
CTTTTGGTCAC -> TTTTGGTCACG
CTTTTGGTCTC -> TTTTGGTCTCA
CTTTTGTATCT -> TTTTGTATCTC
GAAAACACGAT -> AAAACACGATT
GAAAACTTCTA -> AAAACTTCTAT
GAAAAGTGAGC -> AAAAGTGAGCA
GAAACGCTGAA -> AAACGCTGAAC
GAAACGCTGTC -> AAACGCTGTCA
GAAACTGAAGG -> AAACTGAAGGC
GAAAGACCCCT -> AAAGACCCCTA
GAAAGCGCCCA -> AAAGCGCCCAG
GAAAGTACGAC -> AAAGTACGACG
GAAATGCGTAC -> AAATGCGTACT
GAACACGCACT -> AACACGCACTT
GAACAGTTTTC -> AACAGTTTTCC
GAACATCGGAC -> AACATCGGACA
GAACATTCACT -> AACATTCACTG
GAACCGAGTGT -> AACCGAGTGTC
GAACCTTGGCC -> AACCTTGGCCA
GAACGAAGGTA -> AACGAAGGTAA
GAACGACTCCA -> AACGACTCCAG
GAACTACATGC -> AACTACATGCT
GAACTACCATG -> AACTACCATGG
GAACTGAGGCA -> AACTGAGGCAC
GAACTGCCCTT -> AACTGCCCTTT
GAACTGTGTGG -> AACTGTGTGGG
GAAGAACAGTT -> AAGAACAGTTT
GAAGAGGAATG -> AAGAGGAATGA
GAAGATACGAA -> AAGATACGAAA
GAAGCATACAG -> AAGCATACAGC
GAAGGATTTTG -> AAGGATTTTGT
GAAGGCGTATG -> AAGGCGTATGT
GAAGGTAATGG -> AAGGTAATGGA
GAAGGTAATTT -> AAGGTAATTTA
GAAGTAGTGCC -> AAGTAGTGCCA
GAATACACTCG -> AATACACTCGA
GAATACTGGAG -> AATACTGGAGA
GAATCCCCACG -> AATCCCCACGA
GAATCCGGGTA -> AATCCGGGTAG
GAATCGACGCC -> AATCGACGCCT
GAATCTGTAGT -> AATCTGTAGTT
GAATGATAGAT -> AATGATAGATG
GAATGCACCCG -> AATGCACCCGC
GAATGCTTGTC -> AATGCTTGTCC
GAATGGTGGTA -> AATGGTGGTAT
GAATTGAACTA -> AATTGAACTAC
GACACGAAAAC -> ACACGAAAACT
GACAGCTTTAG -> ACAGCTTTAGT
GACAGTAGACG -> ACAGTAGACGC
GACATGGAGTA -> ACATGGAGTAT
GACATGTGCTT -> ACATGTGCTTG
GACATTCTTTT -> ACATTCTTTTC
GACCATCAAAA -> ACCATCAAAAC
GACCCCTAGTT -> ACCCCTAGTTG
GACCGCACGAG -> ACCGCACGAGC
GACCTTCTTGT -> ACCTTCTTGTC
GACGACATGTG -> ACGACATGTGC
GACGACATTCT -> ACGACATTCTT
GACGCAGTTAT -> ACGCAGTTATC
GACGCCACTTT -> ACGCCACTTTA
GACGCCTCGCA -> ACGCCTCGCAA
GACGCGAGATC -> ACGCGAGATCC
GACGCTAGCCT -> ACGCTAGCCTC
GACGTAGGTGC -> ACGTAGGTGCT
GACGTCCCTCA -> ACGTCCCTCAT
GACGTCGCGTG -> ACGTCGCGTGA
GACGTCGTCCG -> ACGTCGTCCGA
GACTATCCATC -> ACTATCCATCC
GACTATCGGCA -> ACTATCGGCAC
GACTCCAGACG -> ACTCCAGACGT
GACTGGCGCCA -> ACTGGCGCCAG
GAGAACATTCA -> AGAACATTCAC
GAGAACTGCCC -> AGAACTGCCCT
GAGAAGGTAAT -> AGAAGGTAATG
GAGAATGGTGG -> AGAATGGTGGT
GAGACTATCGG -> AGACTATCGGC
GAGAGCAACCG -> AGAGCAACCGG
GAGAGCATACA -> AGAGCATACAG
GAGAGCGAAAC -> AGAGCGAAACT
GAGAGCGGATG -> AGAGCGGATGA
GAGATCCCCAT -> AGATCCCCATG
GAGATTAAATC -> AGATTAAATCA
GAGCAACCGGC -> AGCAACCGGCG
GAGCAACGAGA -> AGCAACGAGAA
GAGCACCGTAA -> AGCACCGTAAG
GAGCATAACCG -> AGCATAACCGA
GAGCATACAGG -> AGCATACAGGG
GAGCATAGGAA -> AGCATAGGAAA
GAGCATTGAAC -> AGCATTGAACC
GAGCGAAACTG -> AGCGAAACTGA
GAGCGGATGAG -> AGCGGATGAGG
GAGCGTCAGCG -> AGCGTCAGCGG
GAGCTAATTGG -> AGCTAATTGGT
GAGCTCGAATC -> AGCTCGAATCC
GAGCTGTAAAC -> AGCTGTAAACC
GAGCTTAGTTG -> AGCTTAGTTGC
GAGCTTCTAGC -> AGCTTCTAGCA
GAGCTTTTGGT -> AGCTTTTGGTC,AGCTTTTGGTC
GAGGAATCGAC -> AGGAATCGACG
GAGGAATGATA -> AGGAATGATAG
GAGGCACCGCC -> AGGCACCGCCG
GAGGGGAGCTC -> AGGGGAGCTCG
GAGTATTAGTC -> AGTATTAGTCA
GAGTGGCACCA -> AGTGGCACCAT
GAGTGTAACGT -> AGTGTAACGTG
GAGTGTCGCAT -> AGTGTCGCATC
GATAACTCATG -> ATAACTCATGA
GATAATAGAGA -> ATAATAGAGAT
GATACGAAACG -> ATACGAAACGC
GATACGCTACA -> ATACGCTACAG
GATAGAATGCT -> ATAGAATGCTT
GATAGATGATT -> ATAGATGATTA
GATATAATCAC -> ATATAATCACT
GATATCTTGGC -> ATATCTTGGCA
GATATGAGAAT -> ATATGAGAATG
GATATGTGCCC -> ATATGTGCCCA
GATCAGTCGGC -> ATCAGTCGGCT
GATCATGATCG -> ATCATGATCGG
GATCCCCATGT -> ATCCCCATGTG
GATCCGTTCGG -> ATCCGTTCGGA
GATCGGGTCGG -> ATCGGGTCGGC
GATGAGGAATC -> ATGAGGAATCG
GATGATAATAG -> ATGATAATAGA
GATGATTATCT -> ATGATTATCTT
GATGATTCGGC -> ATGATTCGGCC
GATGGGCTCAC -> ATGGGCTCACT
GATGGTCGGTT -> ATGGTCGGTTT
GATTAAATCAT -> ATTAAATCATA
GATTAAGTCGA -> ATTAAGTCGAA
GATTATCTTAG -> ATTATCTTAGA
GATTCGGCCCC -> ATTCGGCCCCT
GATTCTGCATG -> ATTCTGCATGA
GATTGAAAGAC -> ATTGAAAGACC
GATTTGAAAAC -> ATTTGAAAACA
GATTTGTCTTG -> ATTTGTCTTGG
GATTTTCATAC -> ATTTTCATACA
GATTTTGTGTC -> ATTTTGTGTCT
GCAAAAAGAAG -> CAAAAAGAAGA
GCAACCCGAGA -> CAACCCGAGAA
GCAACCGGCGT -> CAACCGGCGTT
GCAACGAGAAC -> CAACGAGAACA
GCAATTGAATA -> CAATTGAATAC
GCACACGTTGT -> CACACGTTGTC
GCACATGATCA -> CACATGATCAA
GCACCATACGA -> CACCATACGAA
GCACCCGAGCT -> CACCCGAGCTT
GCACCCGCCCG -> CACCCGCCCGT
GCACCGCCGCT -> CACCGCCGCTA
GCACCGTAAGC -> CACCGTAAGCA
GCACCTGTCCA -> CACCTGTCCAT
GCACGAGCTGT -> CACGAGCTGTA
GCACTTCAAAG -> CACTTCAAAGG
GCAGCGTGTCG -> CAGCGTGTCGG
GCAGCTGCCTT -> CAGCTGCCTTT
GCAGGGTCACT -> CAGGGTCACTT
GCAGTTATCAA -> CAGTTATCAAA
GCATAACCGAA -> CATAACCGAAT
GCATACAGCGG -> CATACAGCGGT
GCATACAGGGT -> CATACAGGGTT
GCATAGCGTCA -> CATAGCGTCAC
GCATAGGAAAA -> CATAGGAAAAG
GCATCGGTTGA -> CATCGGTTGAG
GCATGAAGAAC -> CATGAAGAACA
GCATTCACCGA -> CATTCACCGAC
GCATTGAACCG -> CATTGAACCGA
GCCAAATGAGT -> CCAAATGAGTG
GCCAAGCGTTC -> CCAAGCGTTCA
GCCACAATGTC -> CCACAATGTCT
GCCACCAAGAC -> CCACCAAGACA
GCCACGCGGCA -> CCACGCGGCAG
GCCACGTGGTC -> CCACGTGGTCG
GCCACTTTAAC -> CCACTTTAACG
GCCAGATGATA -> CCAGATGATAA
GCCAGGGTAGT -> CCAGGGTAGTA
GCCAGTTCGGT -> CCAGTTCGGTA
GCCAGTTTTTA -> CCAGTTTTTAC
GCCATGCGGAG -> CCATGCGGAGA
GCCCAACGTGA -> CCCAACGTGAC
GCCCAGGCCAC -> CCCAGGCCACC
GCCCAGGTCAA -> CCCAGGTCAAA
GCCCCTATGGA -> CCCCTATGGAG
GCCCCTTACCT -> CCCCTTACCTG
GCCCGTCTTCT -> CCCGTCTTCTT
GCCCTTTACGG -> CCCTTTACGGG
GCCGCGCACCT -> CCGCGCACCTG
GCCGCGGACAT -> CCGCGGACATG
GCCGCTACGGC -> CCGCTACGGCC
GCCGGCATAGC -> CCGGCATAGCG
GCCTCGCAAAA -> CCTCGCAAAAA
GCCTCGCGTAC -> CCTCGCGTACG
GCCTTTTATGT -> CCTTTTATGTA
GCGAAACTGAA -> CGAAACTGAAG
GCGAGATCCCC -> CGAGATCCCCA
GCGAGCATAGG -> CGAGCATAGGA
GCGATAGAATG -> CGATAGAATGC
GCGATATCTTG -> CGATATCTTGG
GCGCACCTGTC -> CGCACCTGTCC
GCGCCAGATGA -> CGCCAGATGAT
GCGCCCAGGCC -> CGCCCAGGCCA
GCGCGTTTTGA -> CGCGTTTTGAT
GCGCTTAAAGG -> CGCTTAAAGGA
GCGGACATGGA -> CGGACATGGAG
GCGGACGTCGC -> CGGACGTCGCG
GCGGAGAGCAA -> CGGAGAGCAAC
GCGGATATGAG -> CGGATATGAGA
GCGGATGAGGA -> CGGATGAGGAA
GCGGCAACCCG -> CGGCAACCCGA
GCGGCAGCTGC -> CGGCAGCTGCC
GCGGGATTTGA -> CGGGATTTGAA
GCGGGCGCTTA -> CGGGCGCTTAA
GCGGTCACATC -> CGGTCACATCC
GCGTAAATATC -> CGTAAATATCA
GCGTACGCCAG -> CGTACGCCAGT
GCGTACTCACA -> CGTACTCACAG
GCGTACTTAAT -> CGTACTTAATG
GCGTATCCATA -> CGTATCCATAC
GCGTATGTTTG -> CGTATGTTTGC
GCGTCACCGGA -> CGTCACCGGAC
GCGTCACTACG -> CGTCACTACGA
GCGTCAGCGGG -> CGTCAGCGGGA
GCGTCGGTCGC -> CGTCGGTCGCC
GCGTGACCGCA -> CGTGACCGCAC
GCGTGTCGGTG -> CGTGTCGGTGA
GCGTTCAATGA -> CGTTCAATGAA
GCGTTCATATG -> CGTTCATATGA
GCGTTGGTTTT -> CGTTGGTTTTT
GCGTTTTGATA -> CGTTTTGATAA
GCTAACGGTAC -> CTAACGGTACC
GCTAATTGGTG -> CTAATTGGTGG
GCTACACTCCG -> CTACACTCCGG,CTACACTCCGT
GCTACAGATTG -> CTACAGATTGA
GCTACGGCCAG -> CTACGGCCAGT
GCTAGCCTCGC -> CTAGCCTCGCG
GCTATACTCGG -> CTATACTCGGG,CTATACTCGGA
GCTCACTTCTG -> CTCACTTCTGA
GCTCAGAGCTT -> CTCAGAGCTTT
GCTCCAACTGG -> CTCCAACTGGC
GCTCCAGAACA -> CTCCAGAACAT
GCTCCCTGGGC -> CTCCCTGGGCG
GCTCGAATCCC -> CTCGAATCCCC
GCTGAACCTTG -> CTGAACCTTGG
GCTGACTGGCG -> CTGACTGGCGC
GCTGATACGCT -> CTGATACGCTA
GCTGATATAAT -> CTGATATAATC
GCTGCCTTTTA -> CTGCCTTTTAT
GCTGCTACACT -> CTGCTACACTC
GCTGGCATTCA -> CTGGCATTCAC
GCTGTAAACCG -> CTGTAAACCGA
GCTGTCATTCT -> CTGTCATTCTG
GCTTAAAGGAT -> CTTAAAGGATC
GCTTAAGGGGG -> CTTAAGGGGGT
GCTTACTGTGC -> CTTACTGTGCT
GCTTAGTTGCG -> CTTAGTTGCGA
GCTTCTAGCAG -> CTTCTAGCAGG
GCTTGTCCAAC -> CTTGTCCAACT
GCTTGTCTGAA -> CTTGTCTGAAT
GCTTTAGTGCG -> CTTTAGTGCGG
GCTTTTGGTCA -> CTTTTGGTCAC
GCTTTTGGTCT -> CTTTTGGTCTC
GCTTTTGTATC -> CTTTTGTATCT
GGAAAAGTGAG -> GAAAAGTGAGC
GGAAACGCTGT -> GAAACGCTGTC
GGAAAGCGCCC -> GAAAGCGCCCA
GGAACGACTCC -> GAACGACTCCA
GGAAGCATACA -> GAAGCATACAG
GGAAGTAGTGC -> GAAGTAGTGCC
GGAATCGACGC -> GAATCGACGCC
GGAATGATAGA -> GAATGATAGAT
GGAATGCACCC -> GAATGCACCCG
GGAATTGAACT -> GAATTGAACTA
GGACACGAAAA -> GACACGAAAAC
GGACATGGAGT -> GACATGGAGTA
GGACGCAGTTA -> GACGCAGTTAT
GGACGCCACTT -> GACGCCACTTT
GGACGTCGCGT -> GACGTCGCGTG
GGAGAAGGTAA -> GAGAAGGTAAT
GGAGAGCAACC -> GAGAGCAACCG
GGAGAGCGAAA -> GAGAGCGAAAC
GGAGCATAACC -> GAGCATAACCG
GGAGCTCGAAT -> GAGCTCGAATC
GGAGTATTAGT -> GAGTATTAGTC
GGATATGAGAA -> GATATGAGAAT
GGATCCGTTCG -> GATCCGTTCGG
GGATGAGGAAT -> GATGAGGAATC
GGATGGGCTCA -> GATGGGCTCAC
GGATGGTCGGT -> GATGGTCGGTT
GGATTTGAAAA -> GATTTGAAAAC
GGATTTGTCTT -> GATTTGTCTTG
GGATTTTGTGT -> GATTTTGTGTC
GGCAACCCGAG -> GCAACCCGAGA
GGCACACGTTG -> GCACACGTTGT
GGCACCATACG -> GCACCATACGA
GGCACCCGAGC -> GCACCCGAGCT
GGCACCGCCGC -> GCACCGCCGCT
GGCAGCTGCCT -> GCAGCTGCCTT
GGCATAGCGTC -> GCATAGCGTCA
GGCATTCACCG -> GCATTCACCGA
GGCCACAATGT -> GCCACAATGTC
GGCCACCAAGA -> GCCACCAAGAC
GGCCACGCGGC -> GCCACGCGGCA
GGCCAGTTCGG -> GCCAGTTCGGT
GGCCCAACGTG -> GCCCAACGTGA
GGCCCCTATGG -> GCCCCTATGGA
GGCCCCTTACC -> GCCCCTTACCT
GGCCGCGGACA -> GCCGCGGACAT
GGCGATATCTT -> GCGATATCTTG
GGCGCCAGATG -> GCGCCAGATGA
GGCGCGTTTTG -> GCGCGTTTTGA
GGCGCTTAAAG -> GCGCTTAAAGG
GGCGGCAACCC -> GCGGCAACCCG
GGCGGGCGCTT -> GCGGGCGCTTA
GGCGTACTTAA -> GCGTACTTAAT
GGCGTATCCAT -> GCGTATCCATA
GGCGTATGTTT -> GCGTATGTTTG
GGCGTCACTAC -> GCGTCACTACG
GGCGTTCATAT -> GCGTTCATATG
GGCTAACGGTA -> GCTAACGGTAC
GGCTCACTTCT -> GCTCACTTCTG
GGCTGATATAA -> GCTGATATAAT
GGGAAGCATAC -> GGAAGCATACA
GGGAAGTAGTG -> GGAAGTAGTGC
GGGAATGCACC -> GGAATGCACCC
GGGAATTGAAC -> GGAATTGAACT
GGGAGCTCGAA -> GGAGCTCGAAT
GGGATGGGCTC -> GGATGGGCTCA
GGGATTTGAAA -> GGATTTGAAAA
GGGCCCAACGT -> GGCCCAACGTG
GGGCCCCTATG -> GGCCCCTATGG
GGGCGATATCT -> GGCGATATCTT
GGGCGCTTAAA -> GGCGCTTAAAG
GGGCGTACTTA -> GGCGTACTTAA
GGGCGTCACTA -> GGCGTCACTAC
GGGCTCACTTC -> GGCTCACTTCT
GGGGAAGTAGT -> GGGAAGTAGTG
GGGGAATTGAA -> GGGAATTGAAC
GGGGAGCTCGA -> GGGAGCTCGAA
GGGGCCCCTAT -> GGGCCCCTATG
GGGGCGATATC -> GGGCGATATCT
GGGGGAATTGA -> GGGGAATTGAA
GGGGGCGATAT -> GGGGCGATATC
GGGGGTTTCCG -> GGGGTTTCCGG
GGGGTTCTAGA -> GGGTTCTAGAT
GGGGTTTCCGG -> GGGTTTCCGGT
GGGTACTTAAA -> GGTACTTAAAG
GGGTAGCGGAC -> GGTAGCGGACG
GGGTAGCTCAG -> GGTAGCTCAGA
GGGTAGTATGC -> GGTAGTATGCT
GGGTCACTTGA -> GGTCACTTGAG
GGGTCATTTGA -> GGTCATTTGAC
GGGTCCAGTCC -> GGTCCAGTCCA
GGGTCGGCGGG -> GGTCGGCGGGC
GGGTCTTCTGT -> GGTCTTCTGTG
GGGTTATTGGA -> GGTTATTGGAA
GGGTTCAAAAA -> GGTTCAAAAAG
GGGTTCTAGAT -> GGTTCTAGATA
GGGTTTCCGGT -> GGTTTCCGGTA
GGTAACCAGGT -> GTAACCAGGTA
GGTAATGGACG -> GTAATGGACGC
GGTAATTTAAC -> GTAATTTAACT
GGTAATTTCGC -> GTAATTTCGCT
GGTACCCTAAA -> GTACCCTAAAA
GGTACTTAAAG -> GTACTTAAAGC
GGTAGAAAGTA -> GTAGAAAGTAC
GGTAGCAGCGT -> GTAGCAGCGTG
GGTAGCCAAGC -> GTAGCCAAGCG
GGTAGCGGACG -> GTAGCGGACGT
GGTAGCTCAGA -> GTAGCTCAGAG
GGTAGTATGCT -> GTAGTATGCTC
GGTATGGCGCG -> GTATGGCGCGT
GGTCAAAGTCG -> GTCAAAGTCGC
GGTCACATCCG -> GTCACATCCGC
GGTCACGGGCG -> GTCACGGGCGT
GGTCACTTGAG -> GTCACTTGAGA
GGTCATTTGAC -> GTCATTTGACC
GGTCCAGTCCA -> GTCCAGTCCAT
GGTCCGGTGTA -> GTCCGGTGTAT
GGTCGACGACA -> GTCGACGACAT
GGTCGCCATGC -> GTCGCCATGCG
GGTCGGCGGGC -> GTCGGCGGGCG
GGTCGGGGAAG -> GTCGGGGAAGT
GGTCGGTTTTT -> GTCGGTTTTTA
GGTCTAGAGCT -> GTCTAGAGCTT
GGTCTCAGCTC -> GTCTCAGCTCC
GGTCTTCTGTG -> GTCTTCTGTGG
GGTGAGACTAT -> GTGAGACTATC
GGTGCTTAAGG -> GTGCTTAAGGG
GGTGGCCACGC -> GTGGCCACGCG
GGTGGGTAGCG -> GTGGGTAGCGG
GGTGGTATGGC -> GTGGTATGGCG
GGTGGTCTAGA -> GTGGTCTAGAG
GGTGTATGAAG -> GTGTATGAAGA
GGTTAAGCCAA -> GTTAAGCCAAA
GGTTATTGGAA -> GTTATTGGAAA
GGTTCAAAAAG -> GTTCAAAAAGC
GGTTCTAGATA -> GTTCTAGATAT
GGTTGAGAGCG -> GTTGAGAGCGG
GGTTTCCGGTA -> GTTTCCGGTAA
GGTTTTTAAGA -> GTTTTTAAGAC
GGTTTTTACTC -> GTTTTTACTCG
GTAAACCGAAG -> TAAACCGAAGG
GTAAATATCAG -> TAAATATCAGG
GTAAATTCCTT -> TAAATTCCTTA
GTAACCAGGTA -> TAACCAGGTAA
GTAACGTGACG -> TAACGTGACGC
GTAAGCAATTG -> TAAGCAATTGA
GTAATGGACGC -> TAATGGACGCC
GTAATTTAACT -> TAATTTAACTG
GTAATTTCGCT -> TAATTTCGCTC
GTACCCTAAAA -> TACCCTAAAAC
GTACGACGACA -> TACGACGACAT
GTACGCCAGTT -> TACGCCAGTTT
GTACTCACAGG -> TACTCACAGGC
GTACTCTAGTA -> TACTCTAGTAG
GTACTTAAAGC -> TACTTAAAGCC
GTACTTAATGA -> TACTTAATGAC
GTAGAAAGTAC -> TAGAAAGTACG
GTAGACGCGAG -> TAGACGCGAGA
GTAGCAGCGTG -> TAGCAGCGTGT
GTAGCCAAGCG -> TAGCCAAGCGT
GTAGCGGACGT -> TAGCGGACGTC
GTAGCTACACT -> TAGCTACACTC
GTAGCTCAGAG -> TAGCTCAGAGC
GTAGCTGCTAC -> TAGCTGCTACA
GTAGGTGCTTA -> TAGGTGCTTAA
GTAGTATGCTC -> TAGTATGCTCC
GTAGTGCCACG -> TAGTGCCACGT
GTAGTTCGCTT -> TAGTTCGCTTT
GTATCCATACC -> TATCCATACCA
GTATCTCTAAG -> TATCTCTAAGG
GTATGAAGAGG -> TATGAAGAGGA
GTATGCTCCAG -> TATGCTCCAGA
GTATGGCGCGT -> TATGGCGCGTT
GTATGTTTGCT -> TATGTTTGCTG
GTATTAGTCAT -> TATTAGTCATG
GTCAAACATTG -> TCAAACATTGG
GTCAAAGTCGC -> TCAAAGTCGCG
GTCACATCCGC -> TCACATCCGCC
GTCACCGGACG -> TCACCGGACGC
GTCACGGGCGT -> TCACGGGCGTA
GTCACTACGAT -> TCACTACGATT
GTCACTTGAGA -> TCACTTGAGAG
GTCAGCGGGAT -> TCAGCGGGATT
GTCATGCACAT -> TCATGCACATG
GTCATTCTGCG -> TCATTCTGCGA
GTCATTTGACC -> TCATTTGACCA
GTCCAACTTGT -> TCCAACTTGTA
GTCCAGTCCAT -> TCCAGTCCATG
GTCCATAATTC -> TCCATAATTCC
GTCCATGGGTT -> TCCATGGGTTC
GTCCCTCATAT -> TCCCTCATATC
GTCCCTCCGAG -> TCCCTCCGAGC
GTCCGAGCTTT -> TCCGAGCTTTT
GTCCGGTGTAT -> TCCGGTGTATG
GTCGAACACGC -> TCGAACACGCA
GTCGACGACAT -> TCGACGACATT
GTCGCATCGGT -> TCGCATCGGTT
GTCGCCATGCG -> TCGCCATGCGG
GTCGCGTCGGT -> TCGCGTCGGTC
GTCGCGTGACC -> TCGCGTGACCG
GTCGGCGGGCG -> TCGGCGGGCGC
GTCGGCTGATA -> TCGGCTGATAT
GTCGGGGAAGT -> TCGGGGAAGTA
GTCGGTCGCCA -> TCGGTCGCCAT
GTCGGTGAGAC -> TCGGTGAGACT
GTCGGTTTTTA -> TCGGTTTTTAA
GTCGTCCGAGC -> TCGTCCGAGCT
GTCTAGAGCTT -> TCTAGAGCTTA
GTCTCAGCTCC -> TCTCAGCTCCA
GTCTGAATACT -> TCTGAATACTG
GTCTGGTTAAG -> TCTGGTTAAGC
GTCTTCTGTGG -> TCTTCTGTGGA
GTCTTCTTATC -> TCTTCTTATCC
GTCTTCTTGAA -> TCTTCTTGAAA
GTCTTGGCTAA -> TCTTGGCTAAC
GTCTTTGGGAT -> TCTTTGGGATG
GTGACCGCACG -> TGACCGCACGA
GTGACGCTAGC -> TGACGCTAGCC
GTGACTATCCA -> TGACTATCCAT
GTGAGACTATC -> TGAGACTATCG
GTGAGCAACGA -> TGAGCAACGAG
GTGCCACGTGG -> TGCCACGTGGT
GTGCCCAGGTC -> TGCCCAGGTCA
GTGCGGATATG -> TGCGGATATGA
GTGCTATACTC -> TGCTATACTCG
GTGCTTAAGGG -> TGCTTAAGGGG
GTGCTTGTCTG -> TGCTTGTCTGA
GTGGAAACGCT -> TGGAAACGCTG
GTGGCACCATA -> TGGCACCATAC
GTGGCCACGCG -> TGGCCACGCGG
GTGGGTAGCGG -> TGGGTAGCGGA
GTGGGTCATTT -> TGGGTCATTTG
GTGGTATGGCG -> TGGTATGGCGC
GTGGTCGACGA -> TGGTCGACGAC
GTGGTCTAGAG -> TGGTCTAGAGC
GTGTAACGTGA -> TGTAACGTGAC
GTGTATGAAGA -> TGTATGAAGAG
GTGTCAAACAT -> TGTCAAACATT
GTGTCGCATCG -> TGTCGCATCGG
GTGTCGGTGAG -> TGTCGGTGAGA
GTGTCTGGTTA -> TGTCTGGTTAA
GTGTGGGTCAT -> TGTGGGTCATT
GTTAAGCCAAA -> TTAAGCCAAAT
GTTATCAAAAG -> TTATCAAAAGG
GTTATCTACGG -> TTATCTACGGG
GTTATTGGAAA -> TTATTGGAAAG
GTTCAAAAAGC -> TTCAAAAAGCT
GTTCAATGAAC -> TTCAATGAACT
GTTCATATGAG -> TTCATATGAGG
GTTCGCTTTTG -> TTCGCTTTTGT
GTTCGGAGAAG -> TTCGGAGAAGG
GTTCGGTAGCA -> TTCGGTAGCAG
GTTCTAGATAT -> TTCTAGATATG
GTTGAGAGCGG -> TTGAGAGCGGA
GTTGCGATAGA -> TTGCGATAGAA
GTTGGGAAGCA -> TTGGGAAGCAT
GTTGGTTTTTA -> TTGGTTTTTAC
GTTGTCCCTCC -> TTGTCCCTCCG
GTTTCCGGTAA -> TTTCCGGTAAC
GTTTGCTGGCA -> TTTGCTGGCAT
GTTTTCCTTAT -> TTTTCCTTATG
GTTTTGATAAC -> TTTTGATAACT
GTTTTTAAGAC -> TTTTTAAGACG
GTTTTTACCTC -> TTTTTACCTCC
GTTTTTACTCG -> TTTTTACTCGG
TAAAACGAGCG -> AAAACGAGCGT
TAAACCGAAGG -> AAACCGAAGGA
TAAAGCCGCGC -> AAAGCCGCGCA
TAAAGGATCCG -> AAAGGATCCGT
TAAATACGGTA -> AAATACGGTAG
TAAATATCAGG -> AAATATCAGGG
TAAATCATAAG -> AAATCATAAGC
TAAATTCCTTA -> AAATTCCTTAA
TAACCAGGTAA -> AACCAGGTAAT
TAACCGAATCT -> AACCGAATCTG
TAACGCGTAAA -> AACGCGTAAAT
TAACGGTACCC -> AACGGTACCCT
TAACGTGACGC -> AACGTGACGCT
TAACTCATGAC -> AACTCATGACA
TAACTGTTATC -> AACTGTTATCT
TAAGACGTAGG -> AAGACGTAGGT
TAAGCAATTGA -> AAGCAATTGAA
TAAGCCAAATG -> AAGCCAAATGA
TAAGCGTTGGT -> AAGCGTTGGTT
TAAGGGGGTTT -> AAGGGGGTTTC
TAAGGGTCCAG -> AAGGGTCCAGT
TAAGTCGAACA -> AAGTCGAACAC
TAATAGAGATT -> AATAGAGATTA
TAATCACTGGC -> AATCACTGGCC
TAATGACCTTC -> AATGACCTTCT
TAATGGACGCC -> AATGGACGCCA
TAATTCCCTCG -> AATTCCCTCGA
TAATTGGTGGG -> AATTGGTGGGT
TAATTTAACTG -> AATTTAACTGT
TAATTTCGCTC -> AATTTCGCTCC
TACACTCCGGT -> ACACTCCGGTC
TACACTCCGTA -> ACACTCCGTAG
TACACTCGAAC -> ACACTCGAACG
TACAGATTGAA -> ACAGATTGAAA
TACAGCGGTCA -> ACAGCGGTCAC
TACAGGGAATG -> ACAGGGAATGC
TACAGGGTTAT -> ACAGGGTTATT
TACATGCTGAC -> ACATGCTGACT
TACCAGAGTGG -> ACCAGAGTGGC
TACCATGGTGG -> ACCATGGTGGT
TACCCTAAAAC -> ACCCTAAAACG
TACCTCCCGGG -> ACCTCCCGGGG
TACCTGGATTT -> ACCTGGATTTG
TACGAAACGCT -> ACGAAACGCTG
TACGAACTGTG -> ACGAACTGTGT
TACGACGACAT -> ACGACGACATG
TACGATTCTGC -> ACGATTCTGCA
TACGCCAGTTT -> ACGCCAGTTTT
TACGCTACAGA -> ACGCTACAGAT
TACGGCCAGTT -> ACGGCCAGTTC
TACGGGGGCGA -> ACGGGGGCGAT
TACGGGTACTT -> ACGGGTACTTA
TACGGTAGCCA -> ACGGTAGCCAA
TACTCACAGGC -> ACTCACAGGCG
TACTCGGATGG -> ACTCGGATGGT
TACTCGGGCCC -> ACTCGGGCCCA
TACTCGGGTCT -> ACTCGGGTCTT
TACTCTAGTAG -> ACTCTAGTAGC
TACTGGAGAGC -> ACTGGAGAGCG
TACTGTGCTAT -> ACTGTGCTATA
TACTTAAAGCC -> ACTTAAAGCCG
TACTTAATGAC -> ACTTAATGACC
TAGAAAGTACG -> AGAAAGTACGA
TAGAATGCTTG -> AGAATGCTTGT
TAGACGCGAGA -> AGACGCGAGAT
TAGAGATTAAA -> AGAGATTAAAT
TAGAGCTTAGT -> AGAGCTTAGTT
TAGATATGTGC -> AGATATGTGCC
TAGATGATTAT -> AGATGATTATC
TAGATTTTCAT -> AGATTTTCATA
TAGCAGCGTGT -> AGCAGCGTGTC
TAGCAGGGTCA -> AGCAGGGTCAC
TAGCCAAGCGT -> AGCCAAGCGTT
TAGCCTCGCGT -> AGCCTCGCGTA
TAGCGGACGTC -> AGCGGACGTCG
TAGCGTCACCG -> AGCGTCACCGG
TAGCTACACTC -> AGCTACACTCC
TAGCTCAGAGC -> AGCTCAGAGCT
TAGCTGCTACA -> AGCTGCTACAC
TAGGAAAAGTG -> AGGAAAAGTGA
TAGGTGCTTAA -> AGGTGCTTAAG
TAGTAGCTACA -> AGTAGCTACAC
TAGTATGCTCC -> AGTATGCTCCA
TAGTCATGCAC -> AGTCATGCACA
TAGTGCCACGT -> AGTGCCACGTG
TAGTGCGGATA -> AGTGCGGATAT
TAGTTCGCTTT -> AGTTCGCTTTT
TAGTTGCGATA -> AGTTGCGATAG
TAGTTGGGAAG -> AGTTGGGAAGC
TATAATCACTG -> ATAATCACTGG
TATACTCGGAT -> ATACTCGGATG
TATACTCGGGT -> ATACTCGGGTC
TATCAAAAGGG -> ATCAAAAGGGG
TATCAGGGGTT -> ATCAGGGGTTC
TATCCATACCA -> ATCCATACCAG
TATCCATCCCT -> ATCCATCCCTG
TATCCTTGCTT -> ATCCTTGCTTA
TATCGGCACAC -> ATCGGCACACG
TATCTACGGGG -> ATCTACGGGGG
TATCTCTAAGG -> ATCTCTAAGGG
TATCTTAGATT -> ATCTTAGATTT
TATCTTGATGA -> ATCTTGATGAT
TATCTTGGCAC -> ATCTTGGCACC
TATGAAGAGGA -> ATGAAGAGGAA
TATGAGAATGG -> ATGAGAATGGT
TATGAGGGGAG -> ATGAGGGGAGC
TATGCCGGCAT -> ATGCCGGCATA
TATGCTCCAGA -> ATGCTCCAGAA
TATGGAGCATA -> ATGGAGCATAA
TATGGCGCGTT -> ATGGCGCGTTT
TATGTACTCTA -> ATGTACTCTAG
TATGTGCCCAG -> ATGTGCCCAGG
TATGTTTGCTG -> ATGTTTGCTGG
TATTAGTCATG -> ATTAGTCATGC
TATTGGAAAGC -> ATTGGAAAGCG
TATTTTGAGCT -> ATTTTGAGCTA
TCAAAAAGCTG -> CAAAAAGCTGA
TCAAAACATTG -> CAAAACATTGG
TCAAAAGGGGC -> CAAAAGGGGCC
TCAAACATTGG -> CAAACATTGGT
TCAAAGGTGGC -> CAAAGGTGGCC
TCAAAGTCGCG -> CAAAGTCGCGT
TCAATGAACTG -> CAATGAACTGA
TCACAGGCGTA -> CACAGGCGTAT
TCACATCCGCC -> CACATCCGCCA
TCACCGACGTC -> CACCGACGTCG
TCACCGGACGC -> CACCGGACGCA
TCACGGGCGTA -> CACGGGCGTAC
TCACTACGATT -> CACTACGATTC
TCACTGATCAT -> CACTGATCATG
TCACTGGCCGC -> CACTGGCCGCG
TCACTTCTGAT -> CACTTCTGATC
TCACTTGAGAG -> CACTTGAGAGC
TCAGAGCTTTT -> CAGAGCTTTTG
TCAGCGGGATT -> CAGCGGGATTT
TCAGCTCCAAC -> CAGCTCCAACT
TCAGGGGTTCT -> CAGGGGTTCTA
TCAGTCGGCTG -> CAGTCGGCTGA
TCATAAGCGTT -> CATAAGCGTTG
TCATACAGGGA -> CATACAGGGAA
TCATATCTTGA -> CATATCTTGAT
TCATATGAGGG -> CATATGAGGGG
TCATGACAGTA -> CATGACAGTAG
TCATGATCGGG -> CATGATCGGGT
TCATGCACATG -> CATGCACATGA
TCATTCTGCGA -> CATTCTGCGAG
TCATTTGACCA -> CATTTGACCAT
TCCAACTGGCG -> CCAACTGGCGG
TCCAACTTGTA -> CCAACTTGTAA
TCCAGAACATC -> CCAGAACATCG
TCCAGACGTCC -> CCAGACGTCCC
TCCAGTCCATG -> CCAGTCCATGG
TCCATAATTCC -> CCATAATTCCC
TCCATACCAGA -> CCATACCAGAG
TCCATCCCTGA -> CCATCCCTGAG
TCCATGGGTTC -> CCATGGGTTCA
TCCCCACGAAT -> CCCCACGAATC
TCCCCATGTGT -> CCCCATGTGTC
TCCCGGGGGAA -> CCCGGGGGAAT
TCCCTCATATC -> CCCTCATATCT
TCCCTCCGAGC -> CCCTCCGAGCA
TCCCTCGAACT -> CCCTCGAACTA
TCCCTGAGCAC -> CCCTGAGCACC
TCCCTGGGCGT -> CCCTGGGCGTC
TCCGAGCATTG -> CCGAGCATTGA
TCCGAGCTTTT -> CCGAGCTTTTG
TCCGCCAGGGT -> CCGCCAGGGTA
TCCGGGTAGCT -> CCGGGTAGCTC
TCCGGTAACCA -> CCGGTAACCAG
TCCGGTCGGGG -> CCGGTCGGGGA
TCCGGTGTATG -> CCGGTGTATGA
TCCGTAGCTGC -> CCGTAGCTGCT
TCCGTTCGGAG -> CCGTTCGGAGA
TCCTTAAATAC -> CCTTAAATACG
TCCTTATGCCG -> CCTTATGCCGG
TCCTTGCTTAC -> CCTTGCTTACT
TCGAACACGCA -> CGAACACGCAC
TCGAACGAAGG -> CGAACGAAGGT
TCGAACTACCA -> CGAACTACCAT
TCGAATCCCCA -> CGAATCCCCAC
TCGACGACATT -> CGACGACATTC
TCGACGCCTCG -> CGACGCCTCGC
TCGCAAAAAGA -> CGCAAAAAGAA
TCGCATCGGTT -> CGCATCGGTTG
TCGCCATGCGG -> CGCCATGCGGA
TCGCGTACGCC -> CGCGTACGCCA
TCGCGTCGGTC -> CGCGTCGGTCG
TCGCGTGACCG -> CGCGTGACCGC
TCGCTCCCTGG -> CGCTCCCTGGG
TCGCTTTTGTA -> CGCTTTTGTAT
TCGGACACGAA -> CGGACACGAAA
TCGGAGAAGGT -> CGGAGAAGGTA
TCGGATGGTCG -> CGGATGGTCGG
TCGGCACACGT -> CGGCACACGTT
TCGGCCCCTTA -> CGGCCCCTTAC
TCGGCGGGCGC -> CGGCGGGCGCT
TCGGCTGATAT -> CGGCTGATATA
TCGGGCCCAAC -> CGGGCCCAACG
TCGGGGAAGTA -> CGGGGAAGTAG
TCGGGTCGGCG -> CGGGTCGGCGG
TCGGGTCTTCT -> CGGGTCTTCTG
TCGGTAGCAGC -> CGGTAGCAGCG
TCGGTCGCCAT -> CGGTCGCCATG
TCGGTGAGACT -> CGGTGAGACTA
TCGGTTGAGAG -> CGGTTGAGAGC
TCGGTTTTTAA -> CGGTTTTTAAG
TCGTCCGAGCT -> CGTCCGAGCTT
TCTAAGGGTCC -> CTAAGGGTCCA
TCTACGGGGGC -> CTACGGGGGCG
TCTAGAGCTTA -> CTAGAGCTTAG
TCTAGATATGT -> CTAGATATGTG
TCTAGCAGGGT -> CTAGCAGGGTC
TCTAGTAGCTA -> CTAGTAGCTAC
TCTATACTCGG -> CTATACTCGGG,CTATACTCGGA
TCTATTTTGAG -> CTATTTTGAGC
TCTCAGCTCCA -> CTCAGCTCCAA
TCTCTAAGGGT -> CTCTAAGGGTC
TCTGAATACTG -> CTGAATACTGG
TCTGATCAGTC -> CTGATCAGTCG
TCTGCATGAAG -> CTGCATGAAGA
TCTGCGAGCAT -> CTGCGAGCATA
TCTGGTTAAGC -> CTGGTTAAGCC
TCTGTAGTTCG -> CTGTAGTTCGC
TCTGTGGAAAC -> CTGTGGAAACG
TCTTAGATTTT -> CTTAGATTTTC
TCTTATCCTTG -> CTTATCCTTGC
TCTTCTGTGGA -> CTTCTGTGGAA
TCTTCTTATCC -> CTTCTTATCCT
TCTTCTTGAAA -> CTTCTTGAAAT
TCTTGAAATGC -> CTTGAAATGCG
TCTTGATGATT -> CTTGATGATTC
TCTTGGCACCC -> CTTGGCACCCG
TCTTGGCTAAC -> CTTGGCTAACG
TCTTGTCTTCT -> CTTGTCTTCTT
TCTTTGGGATG -> CTTTGGGATGG
TCTTTTCTATA -> CTTTTCTATAC
TGAAAACACGA -> GAAAACACGAT
TGAAAGACCCC -> GAAAGACCCCT
TGAAATGCGTA -> GAAATGCGTAC
TGAACCGAGTG -> GAACCGAGTGT
TGAACCTTGGC -> GAACCTTGGCC
TGAACTACATG -> GAACTACATGC
TGAACTGAGGC -> GAACTGAGGCA
TGAAGAACAGT -> GAAGAACAGTT
TGAAGAGGAAT -> GAAGAGGAATG
TGAAGGCGTAT -> GAAGGCGTATG
TGAATACACTC -> GAATACACTCG
TGAATACTGGA -> GAATACTGGAG
TGACAGTAGAC -> GACAGTAGACG
TGACCATCAAA -> GACCATCAAAA
TGACCGCACGA -> GACCGCACGAG
TGACCTTCTTG -> GACCTTCTTGT
TGACGCTAGCC -> GACGCTAGCCT
TGACTATCCAT -> GACTATCCATC
TGACTGGCGCC -> GACTGGCGCCA
TGAGAATGGTG -> GAGAATGGTGG
TGAGACTATCG -> GAGACTATCGG
TGAGAGCATAC -> GAGAGCATACA
TGAGAGCGGAT -> GAGAGCGGATG
TGAGCAACGAG -> GAGCAACGAGA
TGAGCACCGTA -> GAGCACCGTAA
TGAGCTAATTG -> GAGCTAATTGG
TGAGGAATCGA -> GAGGAATCGAC
TGAGGCACCGC -> GAGGCACCGCC
TGAGGGGAGCT -> GAGGGGAGCTC
TGAGTGTAACG -> GAGTGTAACGT
TGATAACTCAT -> GATAACTCATG
TGATAATAGAG -> GATAATAGAGA
TGATACGCTAC -> GATACGCTACA
TGATAGATGAT -> GATAGATGATT
TGATATAATCA -> GATATAATCAC
TGATCAGTCGG -> GATCAGTCGGC
TGATCATGATC -> GATCATGATCG
TGATCGGGTCG -> GATCGGGTCGG
TGATGATTCGG -> GATGATTCGGC
TGATTATCTTA -> GATTATCTTAG
TGATTCGGCCC -> GATTCGGCCCC
TGCACATGATC -> GCACATGATCA
TGCACCCGCCC -> GCACCCGCCCG
TGCATGAAGAA -> GCATGAAGAAC
TGCCACGTGGT -> GCCACGTGGTC
TGCCCAGGTCA -> GCCCAGGTCAA
TGCCCTTTACG -> GCCCTTTACGG
TGCCGGCATAG -> GCCGGCATAGC
TGCCTTTTATG -> GCCTTTTATGT
TGCGAGCATAG -> GCGAGCATAGG
TGCGATAGAAT -> GCGATAGAATG
TGCGGAGAGCA -> GCGGAGAGCAA
TGCGGATATGA -> GCGGATATGAG
TGCGTACTCAC -> GCGTACTCACA
TGCTACACTCC -> GCTACACTCCG
TGCTATACTCG -> GCTATACTCGG
TGCTCCAGAAC -> GCTCCAGAACA
TGCTGACTGGC -> GCTGACTGGCG
TGCTGGCATTC -> GCTGGCATTCA
TGCTTAAGGGG -> GCTTAAGGGGG
TGCTTACTGTG -> GCTTACTGTGC
TGCTTGTCCAA -> GCTTGTCCAAC
TGCTTGTCTGA -> GCTTGTCTGAA
TGGAAACGCTG -> GGAAACGCTGT
TGGAAAGCGCC -> GGAAAGCGCCC
TGGAACGACTC -> GGAACGACTCC
TGGACGCCACT -> GGACGCCACTT
TGGAGAGCGAA -> GGAGAGCGAAA
TGGAGCATAAC -> GGAGCATAACC
TGGAGTATTAG -> GGAGTATTAGT
TGGATTTGTCT -> GGATTTGTCTT
TGGCACCATAC -> GGCACCATACG
TGGCACCCGAG -> GGCACCCGAGC
TGGCATTCACC -> GGCATTCACCG
TGGCCACAATG -> GGCCACAATGT
TGGCCACGCGG -> GGCCACGCGGC
TGGCCGCGGAC -> GGCCGCGGACA
TGGCGCCAGAT -> GGCGCCAGATG
TGGCGCGTTTT -> GGCGCGTTTTG
TGGCGGCAACC -> GGCGGCAACCC
TGGCTAACGGT -> GGCTAACGGTA
TGGGAAGCATA -> GGGAAGCATAC
TGGGATGGGCT -> GGGATGGGCTC
TGGGCGTCACT -> GGGCGTCACTA
TGGGCTCACTT -> GGGCTCACTTC
TGGGTAGCGGA -> GGGTAGCGGAC
TGGGTCATTTG -> GGGTCATTTGA
TGGGTTCAAAA -> GGGTTCAAAAA
TGGTAGAAAGT -> GGTAGAAAGTA
TGGTATGGCGC -> GGTATGGCGCG
TGGTCACGGGC -> GGTCACGGGCG
TGGTCGACGAC -> GGTCGACGACA
TGGTCGGTTTT -> GGTCGGTTTTT
TGGTCTAGAGC -> GGTCTAGAGCT
TGGTCTCAGCT -> GGTCTCAGCTC
TGGTGGGTAGC -> GGTGGGTAGCG
TGGTGGTATGG -> GGTGGTATGGC
TGGTGGTCTAG -> GGTGGTCTAGA
TGGTTAAGCCA -> GGTTAAGCCAA
TGGTTTTTACT -> GGTTTTTACTC
TGTAAACCGAA -> GTAAACCGAAG
TGTAAATTCCT -> GTAAATTCCTT
TGTAACGTGAC -> GTAACGTGACG
TGTACTCTAGT -> GTACTCTAGTA
TGTAGTTCGCT -> GTAGTTCGCTT
TGTATCTCTAA -> GTATCTCTAAG
TGTATGAAGAG -> GTATGAAGAGG
TGTCAAACATT -> GTCAAACATTG
TGTCATTCTGC -> GTCATTCTGCG
TGTCCAACTTG -> GTCCAACTTGT
TGTCCATAATT -> GTCCATAATTC
TGTCCCTCCGA -> GTCCCTCCGAG
TGTCGCATCGG -> GTCGCATCGGT
TGTCGGTGAGA -> GTCGGTGAGAC
TGTCTGAATAC -> GTCTGAATACT
TGTCTGGTTAA -> GTCTGGTTAAG
TGTCTTCTTGA -> GTCTTCTTGAA
TGTCTTGGCTA -> GTCTTGGCTAA
TGTCTTTGGGA -> GTCTTTGGGAT
TGTGCCCAGGT -> GTGCCCAGGTC
TGTGCTATACT -> GTGCTATACTC
TGTGCTTGTCT -> GTGCTTGTCTG
TGTGGAAACGC -> GTGGAAACGCT
TGTGGGTCATT -> GTGGGTCATTT
TGTGTCAAACA -> GTGTCAAACAT
TGTGTCTGGTT -> GTGTCTGGTTA
TGTGTGGGTCA -> GTGTGGGTCAT
TGTTATCTACG -> GTTATCTACGG
TGTTTGCTGGC -> GTTTGCTGGCA
TTAAAGCCGCG -> TAAAGCCGCGC
TTAAAGGATCC -> TAAAGGATCCG
TTAAATACGGT -> TAAATACGGTA
TTAAATCATAA -> TAAATCATAAG
TTAACGCGTAA -> TAACGCGTAAA
TTAACTGTTAT -> TAACTGTTATC
TTAAGACGTAG -> TAAGACGTAGG
TTAAGCCAAAT -> TAAGCCAAATG
TTAAGGGGGTT -> TAAGGGGGTTT
TTAAGTCGAAC -> TAAGTCGAACA
TTAATGACCTT -> TAATGACCTTC
TTACCTCCCGG -> TACCTCCCGGG
TTACCTGGATT -> TACCTGGATTT
TTACGGGTACT -> TACGGGTACTT
TTACTCGGGCC -> TACTCGGGCCC
TTACTGTGCTA -> TACTGTGCTAT
TTAGATTTTCA -> TAGATTTTCAT
TTAGTCATGCA -> TAGTCATGCAC
TTAGTGCGGAT -> TAGTGCGGATA
TTAGTTGCGAT -> TAGTTGCGATA
TTATCAAAAGG -> TATCAAAAGGG
TTATCCTTGCT -> TATCCTTGCTT
TTATCTACGGG -> TATCTACGGGG
TTATCTTAGAT -> TATCTTAGATT
TTATGCCGGCA -> TATGCCGGCAT
TTATGTACTCT -> TATGTACTCTA
TTATTGGAAAG -> TATTGGAAAGC
TTCAAAAAGCT -> TCAAAAAGCTG
TTCAAAGGTGG -> TCAAAGGTGGC
TTCAATGAACT -> TCAATGAACTG
TTCACCGACGT -> TCACCGACGTC
TTCACTGATCA -> TCACTGATCAT
TTCATACAGGG -> TCATACAGGGA
TTCATATGAGG -> TCATATGAGGG
TTCCCTCGAAC -> TCCCTCGAACT
TTCCGGTAACC -> TCCGGTAACCA
TTCCTTAAATA -> TCCTTAAATAC
TTCCTTATGCC -> TCCTTATGCCG
TTCGCTCCCTG -> TCGCTCCCTGG
TTCGCTTTTGT -> TCGCTTTTGTA
TTCGGAGAAGG -> TCGGAGAAGGT
TTCGGCCCCTT -> TCGGCCCCTTA
TTCGGTAGCAG -> TCGGTAGCAGC
TTCTAGATATG -> TCTAGATATGT
TTCTAGCAGGG -> TCTAGCAGGGT
TTCTATACTCG -> TCTATACTCGG
TTCTATTTTGA -> TCTATTTTGAG
TTCTGATCAGT -> TCTGATCAGTC
TTCTGCATGAA -> TCTGCATGAAG
TTCTGCGAGCA -> TCTGCGAGCAT
TTCTGTGGAAA -> TCTGTGGAAAC
TTCTTATCCTT -> TCTTATCCTTG
TTCTTGAAATG -> TCTTGAAATGC
TTCTTGTCTTC -> TCTTGTCTTCT
TTCTTTTCTAT -> TCTTTTCTATA
TTGAAAACACG -> TGAAAACACGA
TTGAAAGACCC -> TGAAAGACCCC
TTGAAATGCGT -> TGAAATGCGTA
TTGAACCGAGT -> TGAACCGAGTG
TTGAACTACAT -> TGAACTACATG
TTGAATACACT -> TGAATACACTC
TTGACCATCAA -> TGACCATCAAA
TTGAGAGCATA -> TGAGAGCATAC
TTGAGAGCGGA -> TGAGAGCGGAT
TTGAGCTAATT -> TGAGCTAATTG
TTGATAACTCA -> TGATAACTCAT
TTGATGATTCG -> TGATGATTCGG
TTGCGATAGAA -> TGCGATAGAAT
TTGCTGGCATT -> TGCTGGCATTC
TTGCTTACTGT -> TGCTTACTGTG
TTGGAAAGCGC -> TGGAAAGCGCC
TTGGAACGACT -> TGGAACGACTC
TTGGCACCCGA -> TGGCACCCGAG
TTGGCCACAAT -> TGGCCACAATG
TTGGCTAACGG -> TGGCTAACGGT
TTGGGAAGCAT -> TGGGAAGCATA
TTGGGATGGGC -> TGGGATGGGCT
TTGGTAGAAAG -> TGGTAGAAAGT
TTGGTCACGGG -> TGGTCACGGGC
TTGGTCTCAGC -> TGGTCTCAGCT
TTGGTGGGTAG -> TGGTGGGTAGC
TTGGTTTTTAC -> TGGTTTTTACT
TTGTAAATTCC -> TGTAAATTCCT
TTGTATCTCTA -> TGTATCTCTAA
TTGTCCAACTT -> TGTCCAACTTG
TTGTCCCTCCG -> TGTCCCTCCGA
TTGTCTGAATA -> TGTCTGAATAC
TTGTCTTCTTG -> TGTCTTCTTGA
TTGTCTTGGCT -> TGTCTTGGCTA
TTGTGTCTGGT -> TGTGTCTGGTT
TTTAACGCGTA -> TTAACGCGTAA
TTTAACTGTTA -> TTAACTGTTAT
TTTAAGACGTA -> TTAAGACGTAG
TTTACCTCCCG -> TTACCTCCCGG
TTTACGGGTAC -> TTACGGGTACT
TTTACTCGGGC -> TTACTCGGGCC
TTTAGTGCGGA -> TTAGTGCGGAT
TTTATGTACTC -> TTATGTACTCT
TTTCATACAGG -> TTCATACAGGG
TTTCCGGTAAC -> TTCCGGTAACC
TTTCCTTATGC -> TTCCTTATGCC
TTTCGCTCCCT -> TTCGCTCCCTG
TTTCTATACTC -> TTCTATACTCG
TTTGAAAACAC -> TTGAAAACACG
TTTGACCATCA -> TTGACCATCAA
TTTGAGCTAAT -> TTGAGCTAATT
TTTGATAACTC -> TTGATAACTCA
TTTGCTGGCAT -> TTGCTGGCATT
TTTGGGATGGG -> TTGGGATGGGC
TTTGGTCACGG -> TTGGTCACGGG
TTTGGTCTCAG -> TTGGTCTCAGC
TTTGTATCTCT -> TTGTATCTCTA
TTTGTCTTGGC -> TTGTCTTGGCT
TTTGTGTCTGG -> TTGTGTCTGGT
TTTTAAGACGT -> TTTAAGACGTA
TTTTACCTCCC -> TTTACCTCCCG
TTTTACTCGGG -> TTTACTCGGGC
TTTTATGTACT -> TTTATGTACTC
TTTTCATACAG -> TTTCATACAGG
TTTTCCTTATG -> TTTCCTTATGC
TTTTCTATACT -> TTTCTATACTC
TTTTGAGCTAA -> TTTGAGCTAAT
TTTTGATAACT -> TTTGATAACTC
TTTTGGTCACG -> TTTGGTCACGG
TTTTGGTCTCA -> TTTGGTCTCAG
TTTTGTATCTC -> TTTGTATCTCT
TTTTGTGTCTG -> TTTGTGTCTGG
TTTTTAAGACG -> TTTTAAGACGT
TTTTTACCTCC -> TTTTACCTCCC
TTTTTACTCGG -> TTTTACTCGGG
